Address A,Port A,Address B,Port B,Packets,Bytes,Stream ID,Total Packets,Percent Filtered,Packets A to B,Bytes A to B,Packets B to A,Bytes B to A,Rel Start,Duration,Bits A to B,Bits B to A,classification
192.168.10.126,65247,192.168.10.1,53,15,1101,570,0,0,10,668,5,433,310.026842,0.023248,229869,149002,Admin
192.168.10.126,65248,192.168.10.1,53,15,1142,571,0,0,10,668,5,474,310.027019,0.023072,231622,164355,Admin
192.168.10.126,65249,192.168.10.1,53,17,1209,572,0,0,12,776,5,433,310.027127,0.022966,270312,150831,Admin
192.168.10.126,65250,3.86.127.24,443,47,15710,573,0,0,30,8624,17,7086,310.044306,61.170215,1127,926,Unclear
192.168.10.126,65242,79.127.213.244,443,315,144063,565,0,0,200,74424,115,69639,310.211671,198.036471,3006,2813,Google
192.168.10.126,65234,79.127.213.240,443,30,12072,557,0,0,20,6464,10,5608,310.211782,32.021968,1614,1401,Google
192.168.10.126,61729,192.168.10.117,8009,561,67962,14,0,0,434,50740,127,17222,310.259568,494.637138,820,278,Admin
192.168.10.126,61727,192.168.10.117,8009,611,74118,15,0,0,464,55660,147,18458,310.259576,494.638605,900,298,Admin
192.168.10.126,61957,149.154.170.200,443,1029,160784,7,0,0,702,106400,327,54384,310.297907,497.491148,1710,874,Unclear
2620:1ec:21::14,443,2406:3003:2003:1c3b:dfc:2032:c4e:dc7,61794,609,271070,38,0,0,207,26774,402,244296,310.579707,493.130468,434,3963,Google
2603:1046:c01:1006::2,443,2406:3003:2003:1c3b:dd11:a88e:d7a1:7c72,62449,881,266427,11,0,0,319,60825,562,205602,310.916474,496.323043,980,3314,Google
192.168.10.126,65227,79.127.213.241,443,71,27014,551,0,0,46,14872,25,12142,311.213125,262.448494,453,370,Google
79.127.213.241,443,192.168.10.126,65246,11,2951,569,0,0,3,1175,8,1776,312.148016,12.100791,776,1174,Admin
192.168.10.126,65241,68.232.45.61,443,16078,17379383,564,0,0,4446,291268,11632,17088115,312.210116,261.453469,8912,522865,Unclear
79.127.213.240,443,192.168.10.126,65244,30,11858,567,0,0,10,4158,20,7700,312.309811,32.919148,1010,1871,Admin
192.168.10.126,65245,79.127.213.240,443,14,4023,568,0,0,10,3228,4,795,312.327322,12.900841,2001,492,Google
192.168.10.126,65251,10.91.207.234,7680,10,660,574,0,0,10,660,0,0,313.669365,15.005289,351,0,Unclear
192.168.10.126,65252,10.91.46.175,7680,10,660,575,0,0,10,660,0,0,313.670549,15.002862,351,0,Unclear
52.0.218.127,443,192.168.10.126,61837,210,32483,21,0,0,54,5499,156,26984,314.072684,493.138297,89,437,Admin
2603:1063:2202:38::25,443,2406:3003:2003:1c3b:dd11:a88e:d7a1:7c72,62158,229,21863,0,0,0,97,10559,132,11304,314.072684,483.544476,174,187,Google
2406:3003:2003:1c3b:dd11:a88e:d7a1:7c72,65253,2603:1063:2200::12,443,268,174499,576,0,0,206,102202,62,72297,315.211621,258.667645,3160,2235,Google
2406:3003:2003:1c3b:dd11:a88e:d7a1:7c72,65254,2603:1063:2200::12,443,33,11217,577,0,0,22,4314,11,6903,315.214432,124.613113,276,443,Google
2406:3003:2003:1c3b:dd11:a88e:d7a1:7c72,65255,2603:1063:2200::12,443,283,177175,578,0,0,214,94108,69,83067,315.215658,258.663396,2910,2569,Google
2406:3003:2003:1c3b:dd11:a88e:d7a1:7c72,65256,2603:1063:2200::12,443,29,7834,579,0,0,20,2374,9,5460,315.462514,75.990922,249,574,Google
192.168.10.126,65257,52.108.186.5,443,5,330,580,0,0,2,132,3,198,315.763059,9.250673,114,171,Unclear
192.168.10.1,53,192.168.10.126,65240,4,264,563,0,0,4,264,0,0,315.766176,84.921672,24,0,Admin
2406:3003:2003:1c3b:dfc:2032:c4e:dc7,61951,2a03:2880:f20c:2c6:face:b00c:0:167,443,158,18214,37,0,0,104,12056,54,6158,316.207937,489.306946,197,100,Google
79.127.213.243,443,192.168.10.126,65169,13,3050,493,0,0,5,1290,8,1760,316.672997,10.846263,951,1298,Admin
192.168.10.126,65258,192.168.10.1,53,15,1030,581,0,0,10,636,5,394,317.213616,0.020974,242586,150281,Admin
192.168.10.126,65259,192.168.10.1,53,17,1090,582,0,0,12,744,5,346,317.213946,0.016393,363081,168852,Admin
192.168.10.126,65260,192.168.10.1,53,17,1126,583,0,0,12,744,5,382,317.214179,0.026721,222746,114366,Admin
192.168.10.126,65261,69.165.105.13,443,126,60454,584,0,0,74,21788,52,38666,317.235604,256.658137,679,1205,Unclear
192.168.10.126,61838,18.211.194.112,443,85,8704,39,0,0,68,6154,17,2550,317.275623,486.480349,101,41,Unclear
192.168.10.126,65262,69.165.105.13,443,22,2547,585,0,0,16,2064,6,483,317.487885,62.001058,266,62,Unclear
192.168.10.126,65151,54.91.59.199,443,11,632,476,0,0,6,326,5,306,320.519897,10.941705,238,223,Unclear
2406:3003:2003:1c3b:dfc:2032:c4e:dc7,62081,2404:6800:4003:c02::66,80,87,9751,53,0,0,58,6330,29,3421,320.880791,480.181784,105,56,Google
192.168.10.126,65263,79.127.213.241,443,66,25530,586,0,0,42,12340,24,13190,324.210277,41.015183,2406,2572,Google
192.168.10.126,65264,79.127.213.241,443,34,8621,587,0,0,22,3132,12,5489,327.215067,11.02587,2272,3982,Google
192.168.10.126,65265,192.168.10.1,53,17,1102,588,0,0,12,744,5,358,331.22268,0.022639,262909,126507,Admin
192.168.10.126,65266,192.168.10.1,53,17,1078,589,0,0,12,744,5,334,331.223115,0.016211,367158,164826,Admin
192.168.10.126,65267,192.168.10.1,53,17,1153,590,0,0,12,744,5,409,331.223365,0.02194,271285,149134,Admin
2406:3003:2003:1c3b:dfc:2032:c4e:dc7,61834,2404:6800:4003:c1c::bc,5228,39,3118,45,0,0,26,1998,13,1120,331.225332,464.140215,34,19,Google
2406:3003:2003:1c3b:dd11:a88e:d7a1:7c72,65268,2001:67c:4e8:f004::9,443,62,16294,591,0,0,38,7656,24,8638,331.241451,181.287714,337,381,Unclear
192.168.10.126,65269,192.168.10.1,53,15,1074,592,0,0,10,630,5,444,331.249481,0.216555,23273,16402,Admin
192.168.10.126,65270,192.168.10.1,53,17,1193,593,0,0,12,738,5,455,331.249644,0.024891,237194,146237,Admin
192.168.10.126,65271,192.168.10.1,53,15,1086,594,0,0,10,630,5,456,331.24976,0.026575,189651,137271,Admin
192.168.10.126,65272,54.91.59.199,443,64,15084,595,0,0,42,9016,22,6068,331.462741,59.209028,1218,819,Unclear
192.168.10.126,65273,79.127.213.240,443,38,11227,596,0,0,24,4600,14,6627,332.284034,13.989568,2630,3789,Google
192.168.10.126,65274,54.91.59.199,443,77,28066,597,0,0,50,16040,27,12026,332.754214,121.232331,1058,793,Unclear
192.168.10.126,65275,54.91.59.199,443,55,13850,598,0,0,36,6878,19,6972,333.005847,120.985778,454,461,Unclear
192.168.10.126,65276,54.91.59.199,443,58,11643,599,0,0,36,5288,22,6355,334.163724,119.841582,352,424,Unclear
192.168.10.126,65277,192.168.10.1,53,15,1172,600,0,0,10,662,5,510,335.228889,0.033932,156076,120240,Admin
192.168.10.126,65278,192.168.10.1,53,17,1244,601,0,0,12,770,5,474,335.229175,0.028449,216527,133291,Admin
192.168.10.126,65279,192.168.10.1,53,17,1269,602,0,0,12,770,5,499,335.229544,0.031729,194144,125815,Admin
192.168.10.126,65280,192.168.10.1,53,17,1176,603,0,0,12,760,5,416,335.241808,0.036324,167382,91619,Admin
192.168.10.126,65281,192.168.10.1,53,17,1168,604,0,0,12,760,5,408,335.242112,0.029106,208891,112141,Admin
192.168.10.126,65282,192.168.10.1,53,17,1188,605,0,0,12,760,5,428,335.242313,0.034599,175727,98962,Admin
192.168.10.126,65283,192.168.10.1,53,17,1293,606,0,0,12,776,5,517,335.248993,0.031388,197782,131770,Admin
192.168.10.126,65284,192.168.10.1,53,15,1149,607,0,0,10,668,5,481,335.249591,0.042289,126368,90992,Admin
192.168.10.126,65285,192.168.10.1,53,15,1186,608,0,0,10,668,5,518,335.249855,0.042739,125038,96960,Admin
2406:3003:2003:1c3b:dd11:a88e:d7a1:7c72,65286,2603:1063:2000::12,443,63,32562,609,0,0,42,24128,21,8434,335.253392,126.459397,1526,533,Google
192.168.10.126,65287,192.168.10.1,53,15,1097,610,0,0,10,634,5,463,335.254637,0.037587,134940,98544,Admin
192.168.10.126,65288,192.168.10.1,53,17,1361,611,0,0,12,742,5,619,335.254928,0.037374,158826,132498,Admin
192.168.10.126,65289,192.168.10.1,53,17,1488,612,0,0,12,742,5,746,335.255136,0.037166,159715,160576,Admin
192.168.10.126,65290,79.127.213.243,443,65,17920,613,0,0,40,8052,25,9868,335.267842,238.395805,270,331,Google
192.168.10.126,65291,192.168.10.1,53,15,1030,614,0,0,10,632,5,398,335.270386,0.02843,177840,111994,Admin
192.168.10.126,65292,192.168.10.1,53,15,1009,615,0,0,10,632,5,377,335.270675,0.033367,151526,90388,Admin
192.168.10.126,65293,192.168.10.1,53,14,1081,616,0,0,10,632,4,449,335.270895,0.032959,153402,108983,Admin
2406:3003:2003:1c3b:dd11:a88e:d7a1:7c72,65294,2603:1063:2000:1::12,443,78,30030,617,0,0,48,13526,30,16504,335.283,238.380826,453,553,Google
192.168.10.126,65295,13.89.179.9,443,133,65467,618,0,0,98,55944,35,9523,335.288239,238.580162,1875,319,Google
192.168.10.126,65296,192.168.10.1,53,17,1290,619,0,0,12,778,5,512,335.590728,0.022016,282703,186046,Admin
192.168.10.126,65297,192.168.10.1,53,17,1249,620,0,0,12,778,5,471,335.591434,0.025145,247524,149850,Admin
192.168.10.126,65298,192.168.10.1,53,17,1294,621,0,0,12,778,5,516,335.591586,0.023984,259506,172114,Admin
192.168.10.126,65299,20.44.10.122,443,13,2197,622,0,0,10,1924,3,273,335.61168,0.831758,18505,2625,Unclear
192.168.10.1,53,192.168.10.126,65088,1,66,419,0,0,1,66,0,0,337.022856,0,,,Admin
192.168.10.126,65300,192.168.10.1,53,17,1219,623,0,0,12,750,5,469,338.044014,0.023951,250511,156653,Admin
192.168.10.126,65301,192.168.10.1,53,15,1095,624,0,0,10,642,5,453,338.044186,0.023749,216261,152595,Admin
192.168.10.126,65302,192.168.10.1,53,17,1157,625,0,0,12,750,5,407,338.044298,0.023682,253356,137488,Admin
192.168.10.126,65303,192.168.10.1,53,15,1080,626,0,0,10,652,5,428,338.335016,0.025931,201149,132042,Admin
192.168.10.126,65304,192.168.10.1,53,15,1060,627,0,0,10,652,5,408,338.335223,0.027137,192209,120278,Admin
192.168.10.126,65305,192.168.10.1,53,17,1188,628,0,0,12,760,5,428,338.33541,0.025515,238291,134195,Admin
192.168.10.126,61802,34.149.211.227,443,20,3990,99,0,0,12,2724,8,1266,338.336494,398.46242,54,25,Unclear
192.168.10.126,65306,192.168.10.1,53,15,1037,629,0,0,10,630,5,407,342.213352,0.035335,142634,92146,Admin
192.168.10.126,65307,192.168.10.1,53,17,1109,630,0,0,12,738,5,371,342.213534,0.035119,168114,84512,Admin
192.168.10.126,65308,192.168.10.1,53,15,1142,631,0,0,10,630,5,512,342.213695,0.03016,167108,135809,Admin
192.168.10.126,65309,192.168.10.1,53,15,1080,632,0,0,10,652,5,428,342.214963,0.04522,115347,75718,Admin
192.168.10.126,65310,192.168.10.1,53,15,1048,633,0,0,10,652,5,396,342.215194,0.033459,155892,94683,Admin
192.168.10.126,65311,192.168.10.1,53,17,1188,634,0,0,12,760,5,428,342.215383,0.043379,140159,78932,Admin
192.168.10.126,65312,79.127.213.244,443,50,16510,635,0,0,32,7680,18,8830,342.245355,24.989383,2458,2826,Google
192.168.10.126,61828,20.212.88.117,443,33,1936,41,0,0,22,1210,11,726,344.852293,450.124946,21,12,Unclear
192.168.10.126,65313,79.127.213.241,443,32,8513,636,0,0,20,3040,12,5473,346.227282,5.067243,4799,8640,Google
192.168.10.126,65314,192.168.10.1,53,19,1267,637,0,0,14,898,5,369,346.531536,1.028581,6984,2869,Admin
192.168.10.126,65315,192.168.10.1,53,17,1123,638,0,0,12,766,5,357,346.531869,0.261919,23396,10904,Admin
192.168.10.126,65316,192.168.10.1,53,17,1164,639,0,0,12,766,5,398,346.53229,0.255265,24006,12473,Admin
192.168.10.126,65317,192.168.10.1,53,15,1036,640,0,0,10,644,5,392,347.515755,0.028571,180322,109761,Admin
192.168.10.126,65318,192.168.10.1,53,15,1024,641,0,0,10,644,5,380,347.516175,0.026648,193335,114079,Admin
192.168.10.126,65319,192.168.10.1,53,17,1173,642,0,0,12,752,5,421,347.516451,0.027118,221845,124197,Admin
192.168.10.126,65320,192.168.10.1,53,17,1135,643,0,0,12,766,5,369,347.542576,0.022593,271234,130659,Admin
192.168.10.126,65321,192.168.10.1,53,21,1404,644,0,0,14,868,7,536,348.209406,0.337858,20553,12691,Admin
192.168.10.126,65322,192.168.10.1,53,15,1060,645,0,0,10,652,5,408,348.209717,0.33995,15343,9601,Admin
192.168.10.126,65323,192.168.10.1,53,17,1188,646,0,0,12,760,5,428,348.209895,0.339776,17894,10077,Admin
192.168.10.126,65324,40.119.249.228,443,42,16609,647,0,0,32,11816,10,4793,348.945239,0.453871,208270,84482,Unclear
192.168.10.126,65325,40.119.249.228,443,46,18299,648,0,0,34,11938,12,6361,349.652498,0.21758,438937,233881,Unclear
192.168.10.126,65326,79.127.213.241,443,55,18774,649,0,0,36,12406,19,6368,351.214018,38.03922,2609,1339,Google
192.168.10.126,65327,10.91.46.175,7680,10,660,650,0,0,10,660,0,0,353.672329,15.007631,351,0,Unclear
192.168.10.126,65328,10.91.115.51,7680,10,660,651,0,0,10,660,0,0,353.67586,15.001619,351,0,Unclear
192.168.10.126,65329,79.127.213.241,443,26,4701,652,0,0,18,3670,8,1031,355.309261,12.984605,2261,635,Google
192.168.10.126,65330,192.168.10.1,53,17,1180,653,0,0,12,740,5,440,357.214302,0.016143,366722,218051,Admin
192.168.10.126,65331,192.168.10.1,53,18,1206,654,0,0,12,740,6,466,357.214672,0.01843,321215,202278,Admin
192.168.10.126,65332,192.168.10.1,53,17,1301,655,0,0,12,740,5,561,357.214882,0.023737,249399,189071,Admin
192.168.10.126,65333,192.168.10.1,53,15,1026,656,0,0,10,638,5,388,359.162645,0.031675,161136,97995,Admin
192.168.10.126,65334,192.168.10.1,53,17,1093,657,0,0,12,746,5,347,359.162888,0.471926,12646,5882,Admin
192.168.10.126,65335,192.168.10.1,53,15,1026,658,0,0,10,638,5,388,359.163069,0.031281,163166,99229,Admin
192.168.10.126,65336,192.168.10.1,53,8,528,659,0,0,2,132,6,396,359.626723,94.394764,11,33,Admin
192.168.10.126,65337,216.239.32.116,443,78,15774,660,0,0,52,7240,26,8534,359.631593,214.450587,270,318,Unclear
192.168.10.126,65338,192.168.10.1,53,17,1188,661,0,0,12,760,5,428,362.21061,0.022638,268574,151250,Admin
192.168.10.126,65339,192.168.10.1,53,17,1156,662,0,0,12,760,5,396,362.211485,0.02169,280313,146058,Admin
192.168.10.126,65340,192.168.10.1,53,17,1188,663,0,0,12,760,5,428,362.212726,0.025744,236171,133001,Admin
192.168.10.126,65341,79.127.213.244,443,48,14113,664,0,0,32,6376,16,7737,365.211521,24.024366,2123,2576,Google
192.168.10.126,65342,192.168.10.1,53,15,1078,665,0,0,10,636,5,442,366.208147,0.034895,145808,101332,Admin
192.168.10.126,65343,192.168.10.1,53,15,1050,666,0,0,10,636,5,414,366.208556,0.03279,155169,101006,Admin
192.168.10.126,65344,192.168.10.1,53,17,1186,667,0,0,12,744,5,442,366.208831,0.034211,173979,103358,Admin
192.168.10.126,65345,79.127.213.244,443,48,14055,668,0,0,32,6346,16,7709,367.213964,22.016313,2305,2801,Google
192.168.10.126,65346,79.127.213.241,443,41,13644,669,0,0,28,6084,13,7560,368.213984,13.060886,3726,4630,Google
192.168.10.126,65347,79.127.213.241,443,34,10997,670,0,0,24,4624,10,6373,368.214978,13.023942,2840,3914,Google
192.168.10.126,65348,192.168.10.1,53,17,1171,671,0,0,12,734,5,437,369.717894,0.01909,307595,183132,Admin
192.168.10.126,65349,192.168.10.1,53,15,1115,672,0,0,10,626,5,489,369.718105,0.020183,248129,193826,Admin
192.168.10.126,65350,192.168.10.1,53,17,1116,673,0,0,12,734,5,382,369.718242,0.026572,220984,115008,Admin
192.168.10.126,65355,192.168.10.1,53,17,1166,674,0,0,12,744,5,422,376.213556,0.02857,208330,118165,Admin
192.168.10.126,65356,192.168.10.1,53,17,1154,675,0,0,12,744,5,410,376.213744,0.028425,209393,115391,Admin
192.168.10.126,65357,192.168.10.1,53,17,1195,676,0,0,12,744,5,451,376.213874,0.028252,210675,127707,Admin
192.168.10.126,65358,192.168.10.1,53,15,1018,677,0,0,10,636,5,382,379.211988,0.22962,22158,13308,Admin
192.168.10.126,65359,192.168.10.1,53,17,1090,678,0,0,12,744,5,346,379.212385,0.227463,26166,12169,Admin
192.168.10.126,65360,192.168.10.1,53,17,1138,679,0,0,12,744,5,394,379.212599,0.227249,26191,13870,Admin
192.168.10.126,65361,79.127.213.241,443,26,4601,680,0,0,18,3570,8,1031,381.216566,11.025861,2590,748,Google
192.168.10.126,61821,20.198.162.78,443,6,352,252,0,0,4,220,2,132,388.867417,245.019252,7,4,Unclear
192.168.10.126,65362,79.127.213.244,443,52,17224,681,0,0,32,7704,20,9520,389.219793,19.067328,3232,3994,Google
192.168.10.126,65363,79.127.213.244,443,50,16577,682,0,0,32,7720,18,8857,389.220447,30.073742,2053,2356,Google
192.168.10.126,65364,54.91.59.199,443,58,14760,683,0,0,38,8800,20,5960,390.486919,60.991811,1154,781,Unclear
192.168.10.126,65365,192.168.10.1,53,17,1194,684,0,0,12,738,5,456,391.463726,0.03135,188325,116363,Admin
192.168.10.126,65366,192.168.10.1,53,15,1085,685,0,0,10,630,5,455,391.463874,0.051129,98574,71192,Admin
192.168.10.126,65367,192.168.10.1,53,17,1194,686,0,0,12,738,5,456,391.463992,0.061694,95698,59130,Admin
192.168.10.126,65368,79.127.213.241,443,34,7418,687,0,0,20,1796,14,5622,392.221581,16.01053,897,2809,Google
192.168.10.126,65369,79.127.213.241,443,64,19761,688,0,0,40,8206,24,11555,392.223653,181.42545,361,509,Google
192.168.10.126,65370,79.127.213.241,443,46,10352,689,0,0,28,3478,18,6874,392.224694,181.196868,153,303,Google
192.168.10.126,65371,79.127.213.241,443,68,20385,690,0,0,44,9318,24,11067,392.226024,181.435662,410,487,Google
192.168.10.126,65372,10.91.89.132,7680,10,660,691,0,0,10,660,0,0,393.674264,15.017894,351,0,Unclear
192.168.10.126,65373,10.91.240.66,7680,10,660,692,0,0,10,660,0,0,393.678257,15.006321,351,0,Unclear
192.168.10.126,65374,192.168.10.1,53,17,1176,693,0,0,12,760,5,416,395.218364,0.03986,152533,83492,Admin
192.168.10.126,65375,192.168.10.1,53,17,1168,694,0,0,12,760,5,408,395.218722,0.034306,177228,95143,Admin
192.168.10.126,65376,192.168.10.1,53,17,1188,695,0,0,12,760,5,428,395.218937,0.033113,183613,103403,Admin
192.168.10.126,65377,79.127.213.244,443,53,17270,696,0,0,34,7788,19,9482,395.247367,28.009654,2224,2708,Google
192.168.10.126,65378,192.168.10.1,53,15,1025,697,0,0,10,630,5,395,395.68926,0.0291,173195,108591,Admin
192.168.10.126,65379,192.168.10.1,53,17,1121,698,0,0,12,738,5,383,395.689539,0.033631,175552,91106,Admin
192.168.10.126,65380,192.168.10.1,53,17,1250,699,0,0,12,738,5,512,395.689954,0.033061,178578,123892,Admin
2406:3003:2003:1c3b:dd11:a88e:d7a1:7c72,65381,2620:1ec:42::132,443,50,39635,700,0,0,18,4152,32,35483,396.202236,64.65025,513,4390,Google
192.168.10.126,65382,192.168.10.1,53,15,1080,701,0,0,10,652,5,428,400.691744,0.131674,39612,26003,Admin
192.168.10.126,65383,192.168.10.1,53,19,1276,702,0,0,14,868,5,408,400.691957,3.074089,2258,1061,Admin
192.168.10.126,65384,192.168.10.1,53,17,1188,703,0,0,12,760,5,428,400.692237,0.138547,43884,24713,Admin
192.168.10.126,65385,192.168.10.1,53,17,1168,704,0,0,12,760,5,408,401.127273,0.144739,42006,22550,Admin
192.168.10.126,65386,192.168.10.1,53,15,991,705,0,0,10,634,5,357,406.209408,0.022011,230430,129753,Admin
192.168.10.126,65387,192.168.10.1,53,15,979,706,0,0,10,634,5,345,406.210046,0.02288,221678,120629,Admin
192.168.10.126,65388,192.168.10.1,53,17,1116,707,0,0,12,742,5,374,406.210525,0.023874,248638,125324,Admin
192.168.10.126,65389,192.168.10.1,53,17,1188,708,0,0,12,760,5,428,408.225919,0.032254,188503,106157,Admin
192.168.10.126,65390,192.168.10.1,53,17,1168,709,0,0,12,760,5,408,408.22622,0.032088,189478,101720,Admin
192.168.10.126,65391,192.168.10.1,53,17,1188,710,0,0,12,760,5,428,408.2266,0.038953,156085,87900,Admin
192.168.10.126,65392,192.168.10.1,53,17,1183,711,0,0,12,742,5,441,408.239186,0.047854,124043,73724,Admin
192.168.10.126,65393,192.168.10.1,53,17,1167,712,0,0,12,742,5,425,408.23946,0.045342,130916,74985,Admin
192.168.10.126,65394,192.168.10.1,53,17,1121,713,0,0,12,742,5,379,408.239678,0.04724,125656,64182,Admin
192.168.10.126,65395,79.127.213.244,443,86,32557,714,0,0,56,16980,30,15577,408.254437,78.98428,1719,1577,Google
2406:3003:2003:1c3b:dd11:a88e:d7a1:7c72,65396,2001:db8:e612:837e:dbe7:9e8c:365a:bf93,443,10,860,715,0,0,10,860,0,0,413.278493,15.001491,458,0,Unclear
2406:3003:2003:1c3b:dd11:a88e:d7a1:7c72,65397,2001:db8:e612:837e:dbe7:9e8c:365a:bf93,443,10,860,716,0,0,10,860,0,0,413.278892,15.003714,458,0,Unclear
192.168.10.126,65398,192.168.10.1,53,22,1485,717,0,0,14,896,8,589,413.582515,0.446859,16040,10544,Admin
192.168.10.126,65399,192.168.10.1,53,24,1569,718,0,0,16,1004,8,565,413.582683,0.446691,17981,10118,Admin
192.168.10.126,65400,192.168.10.1,53,24,1610,719,0,0,16,1004,8,606,413.582793,0.446581,17985,10855,Admin
192.168.10.126,65401,192.168.10.1,53,15,1009,720,0,0,10,654,5,355,413.838799,0.202263,25867,14041,Admin
192.168.10.126,65402,192.168.10.1,53,17,1105,721,0,0,12,762,5,343,413.839021,0.206762,29483,13271,Admin
192.168.10.126,65403,192.168.10.1,53,15,1050,722,0,0,10,654,5,396,413.839346,0.244292,21416,12968,Admin
192.168.10.126,65404,192.168.10.1,53,15,1117,723,0,0,10,662,5,455,413.86935,0.214234,24720,16990,Admin
192.168.10.126,65405,192.168.10.1,53,15,1069,724,0,0,10,662,5,407,413.869584,0.566262,9352,5749,Admin
192.168.10.126,65406,192.168.10.1,53,17,1314,725,0,0,12,770,5,544,413.869726,0.22072,27908,19717,Admin
192.168.10.126,65407,192.168.10.1,53,15,1020,726,0,0,10,640,5,380,414.525821,0.055904,91585,54378,Admin
192.168.10.126,65408,192.168.10.1,53,17,1112,727,0,0,12,748,5,364,414.526534,0.055191,108423,52762,Admin
192.168.10.126,65409,192.168.10.1,53,17,1125,728,0,0,12,748,5,377,414.527248,0.054552,109693,55286,Admin
192.168.10.126,65410,192.168.10.1,53,15,1117,729,0,0,10,662,5,455,414.544303,0.053475,99036,68069,Admin
192.168.10.126,65411,192.168.10.1,53,18,1231,730,0,0,12,770,6,461,414.544905,0.540919,11388,6818,Admin
192.168.10.126,65412,192.168.10.1,53,18,1380,731,0,0,12,770,6,610,414.545224,0.540187,11403,9033,Admin
192.168.10.126,65413,192.168.10.1,53,18,1224,732,0,0,12,762,6,462,414.547105,0.538538,11319,6863,Admin
192.168.10.126,65414,192.168.10.1,53,20,1327,733,0,0,14,870,6,457,414.547925,0.537412,12950,6802,Admin
192.168.10.126,65415,192.168.10.1,53,18,1212,734,0,0,12,762,6,450,414.548186,0.537957,11331,6691,Admin
192.168.10.126,65416,192.168.10.1,53,7,462,735,0,0,2,132,5,330,414.614563,95.028181,11,27,Admin
192.168.10.126,65417,192.168.10.1,53,7,462,736,0,0,2,132,5,330,414.614852,94.209422,11,28,Admin
192.168.10.126,65418,192.168.10.1,53,7,462,737,0,0,2,132,5,330,414.615007,94.599356,11,27,Admin
192.168.10.126,65419,172.253.118.157,443,27,8498,738,0,0,18,2300,9,6198,414.621057,75.433254,243,657,Google
192.168.10.126,65420,192.168.10.1,53,17,1216,739,0,0,12,824,5,392,414.73793,0.353738,18635,8865,Admin
192.168.10.126,65421,192.168.10.1,53,20,1362,740,0,0,14,932,6,430,414.73809,0.357869,20834,9612,Admin
192.168.10.126,65422,192.168.10.1,53,20,1375,741,0,0,14,932,6,443,414.738189,0.356283,20927,9947,Admin
192.168.10.126,65423,192.168.10.1,53,17,1138,742,0,0,12,738,5,400,415.078641,0.025044,235745,127775,Admin
2406:3003:2003:1c3b:dd11:a88e:d7a1:7c72,65424,2406:3003:2003:1c3b:5aef:68ff:febf:8de0,53,2,172,743,0,0,2,172,0,0,415.079335,9.00E-06,,,Google
2406:3003:2003:1c3b:dd11:a88e:d7a1:7c72,65425,2406:3003:2003:1c3b:5aef:68ff:febf:8de0,53,2,172,744,0,0,2,172,0,0,415.079751,6.00E-06,,,Google
192.168.10.126,65426,192.168.10.1,53,15,1018,745,0,0,10,630,5,388,415.553625,0.022913,219962,135468,Admin
192.168.10.126,65427,192.168.10.1,53,17,1167,746,0,0,12,738,5,429,415.553813,0.022766,259334,150751,Admin
192.168.10.126,65428,192.168.10.1,53,15,1080,747,0,0,10,652,5,428,419.210843,0.249648,20893,13715,Admin
192.168.10.126,65429,192.168.10.1,53,15,1048,748,0,0,10,652,5,396,419.211117,0.253913,20542,12476,Admin
192.168.10.126,65430,192.168.10.1,53,17,1176,749,0,0,12,760,5,416,419.211467,0.253565,23978,13124,Admin
192.168.10.126,65431,79.127.213.243,443,43,11796,750,0,0,28,4840,15,6956,419.371703,16.890286,2292,3294,Google
192.168.10.126,65432,79.127.213.244,443,34,8605,751,0,0,22,3132,12,5473,423.209485,11.149276,2247,3927,Google
192.168.10.126,65433,192.168.10.1,53,2,132,752,0,0,2,132,0,0,424.208082,1.10E-05,,,Admin
192.168.10.126,65434,192.168.10.1,53,15,1060,753,0,0,10,652,5,408,424.208457,0.031958,163214,102134,Admin
192.168.10.126,65435,192.168.10.1,53,17,1188,754,0,0,12,760,5,428,424.208682,0.031792,191243,107700,Admin
192.168.10.126,65436,192.168.10.1,53,17,1176,755,0,0,12,760,5,416,424.642485,0.035263,172418,94376,Admin
192.168.10.126,65437,192.168.10.1,53,17,1186,756,0,0,12,744,5,442,427.213475,0.062139,95785,56904,Admin
192.168.10.126,65438,192.168.10.1,53,15,1050,757,0,0,10,636,5,414,427.214118,0.031728,160363,104387,Admin
192.168.10.126,65439,192.168.10.1,53,17,1186,758,0,0,12,744,5,442,427.21472,0.06091,97717,58052,Admin
192.168.10.126,65440,10.91.202.189,7680,10,660,759,0,0,10,660,0,0,433.676197,15.003989,351,0,Unclear
192.168.10.126,65441,10.91.176.120,7680,10,660,760,0,0,10,660,0,0,433.679992,15.002371,351,0,Unclear
2406:3003:2003:1c3b:dd11:a88e:d7a1:7c72,65443,2001:db8:e612:837e:dbe7:9e8c:365a:bf93,443,10,860,761,0,0,10,860,0,0,434.280708,15.000615,458,0,Unclear
192.168.10.126,65445,79.127.213.243,443,39,12294,762,0,0,24,4624,15,7670,436.208423,20.058266,1844,3059,Google
2406:3003:2003:1c3b:dd11:a88e:d7a1:7c72,65446,2603:1047:1:168::18,443,83,31900,763,0,0,64,23350,19,8550,438.949242,0.652662,286212,104801,Google
192.168.10.126,65447,192.168.10.1,53,17,1126,764,0,0,12,744,5,382,442.209801,0.026596,223793,114904,Admin
192.168.10.126,65448,192.168.10.1,53,17,1090,765,0,0,12,744,5,346,442.21015,0.020178,294974,137179,Admin
192.168.10.126,65449,192.168.10.1,53,17,1138,766,0,0,12,744,5,394,442.210424,0.028298,210332,111385,Admin
192.168.10.126,65450,52.20.78.240,443,70,17521,767,0,0,46,9790,24,7731,451.251926,62.21437,1258,994,Unclear
192.168.10.126,65451,192.168.10.1,53,15,1109,768,0,0,10,634,5,475,453.205841,0.049098,103303,77396,Admin
192.168.10.126,65452,192.168.10.1,53,17,1361,769,0,0,12,742,5,619,453.206073,0.052891,112230,93626,Admin
192.168.10.126,65453,192.168.10.1,53,17,1488,770,0,0,12,742,5,746,453.206194,0.0456,130175,130877,Admin
192.168.10.126,65454,192.168.10.1,53,15,1086,771,0,0,10,630,5,456,453.753628,0.031924,157874,114271,Admin
192.168.10.126,65455,192.168.10.1,53,15,1085,772,0,0,10,630,5,455,453.753816,0.063766,79038,57083,Admin
192.168.10.126,65456,192.168.10.1,53,17,1194,773,0,0,12,738,5,456,453.753948,0.067305,87720,54201,Admin
192.168.10.126,65457,52.20.78.240,443,70,25003,774,0,0,48,13716,22,11287,453.818232,120.066714,913,752,Unclear
192.168.10.126,65458,52.20.78.240,443,69,25100,775,0,0,46,13724,23,11376,454.005122,119.878142,915,759,Unclear
192.168.10.126,65459,52.20.78.240,443,56,14260,776,0,0,36,6898,20,7362,454.55617,119.322908,462,493,Unclear
192.168.10.126,65460,192.168.10.1,53,2,132,777,0,0,2,132,0,0,455.210623,9.00E-06,,,Admin
192.168.10.126,65461,192.168.10.1,53,2,132,778,0,0,2,132,0,0,455.210904,4.00E-06,,,Admin
192.168.10.126,65462,192.168.10.1,53,17,1303,779,0,0,12,780,5,523,455.211098,0.040129,155498,104263,Admin
192.168.10.126,65463,192.168.10.1,53,15,1075,780,0,0,10,634,5,441,455.223882,0.038472,131836,91703,Admin
192.168.10.126,65464,192.168.10.1,53,17,1155,781,0,0,12,742,5,413,455.224559,0.052804,112415,62571,Admin
192.168.10.126,65465,192.168.10.1,53,15,1013,782,0,0,10,634,5,379,455.225258,0.041693,121651,72722,Admin
192.168.10.126,65466,192.168.10.1,53,15,1024,783,0,0,10,656,5,368,455.227884,0.049608,105789,59345,Admin
192.168.10.126,65467,192.168.10.1,53,15,1000,784,0,0,10,656,5,344,455.228703,0.049035,107025,56123,Admin
192.168.10.126,65468,192.168.10.1,53,15,1046,785,0,0,10,656,5,390,455.229122,0.05685,92313,54881,Admin
192.168.10.126,65469,192.168.10.1,53,17,1293,786,0,0,12,776,5,517,455.229788,0.047706,130130,86697,Admin
192.168.10.126,65470,192.168.10.1,53,17,1257,787,0,0,12,776,5,481,455.230092,0.047433,130879,81124,Admin
192.168.10.126,65471,192.168.10.1,53,15,1186,788,0,0,10,668,5,518,455.230334,0.055563,96179,74582,Admin
192.168.10.126,65472,79.127.213.244,443,44,13562,789,0,0,28,4808,16,8754,455.230936,25.986197,1480,2694,Google
192.168.10.126,65473,192.168.10.1,53,17,1188,790,0,0,12,760,5,428,455.258595,0.042055,144572,81417,Admin
192.168.10.126,65474,192.168.10.1,53,17,1168,791,0,0,12,760,5,408,455.25887,0.04178,145524,78123,Admin
192.168.10.126,65475,192.168.10.1,53,17,1176,792,0,0,12,760,5,416,455.259049,0.045012,135075,73935,Admin
192.168.10.126,65477,79.127.213.240,443,43,10168,793,0,0,28,3590,15,6578,455.295954,118.367466,242,444,Google
192.168.10.126,65478,192.168.10.1,53,17,1150,794,0,0,12,740,5,410,455.336393,0.036554,161952,89730,Admin
192.168.10.126,65479,192.168.10.1,53,15,1018,795,0,0,10,632,5,386,455.336672,0.045232,111779,68270,Admin
192.168.10.126,65480,192.168.10.1,53,17,1255,796,0,0,12,740,5,515,455.336875,0.04809,123102,85672,Admin
2406:3003:2003:1c3b:dd11:a88e:d7a1:7c72,65481,2606:4700:3110::6812:336a,443,38,9696,797,0,0,24,2614,14,7082,455.356033,15.385269,1359,3682,Google
192.168.10.126,65482,192.168.10.1,53,18,1462,798,0,0,12,884,6,578,455.373765,0.418868,16883,11039,Admin
192.168.10.126,65483,192.168.10.1,53,20,1517,799,0,0,14,992,6,525,455.373959,0.424387,18699,9896,Admin
192.168.10.126,65484,192.168.10.1,53,20,1574,800,0,0,14,992,6,582,455.374171,0.418463,18964,11126,Admin
192.168.10.126,65485,192.168.10.1,53,17,1247,801,0,0,12,780,5,467,455.674975,0.134248,46481,27829,Admin
2406:3003:2003:1c3b:dd11:a88e:d7a1:7c72,65486,2406:3003:2003:1c3b:5aef:68ff:febf:8de0,53,2,172,802,0,0,2,172,0,0,455.675302,4.00E-06,,,Google
192.168.10.126,65487,192.168.10.1,53,17,1188,803,0,0,12,760,5,428,455.819623,0.069708,87220,49119,Admin
192.168.10.126,65488,192.168.10.1,53,17,1168,804,0,0,12,760,5,408,455.819824,0.031307,194205,104257,Admin
192.168.10.126,65489,192.168.10.1,53,17,1188,805,0,0,12,760,5,428,455.819978,0.037834,160702,90500,Admin
192.168.10.126,65490,192.168.10.1,53,17,1235,806,0,0,12,780,5,455,456.149259,0.027728,225043,131275,Admin
192.168.10.126,65491,79.127.213.243,443,36,11119,807,0,0,22,4492,14,6627,456.209225,11.040814,3254,4801,Google
192.168.10.126,65492,192.168.10.1,53,15,1058,808,0,0,10,636,5,422,456.211705,0.034799,146211,97014,Admin
192.168.10.126,65493,192.168.10.1,53,17,1154,809,0,0,12,744,5,410,456.212067,0.034519,172426,95020,Admin
192.168.10.126,65494,192.168.10.1,53,17,1195,810,0,0,12,744,5,451,456.212303,0.034202,174024,105490,Admin
192.168.10.126,65495,79.127.213.240,443,41,10112,811,0,0,26,3364,15,6748,456.452401,117.211179,229,460,Google
192.168.10.126,65496,79.127.213.240,443,33,7363,812,0,0,20,1796,13,5567,456.474252,15.75269,912,2827,Google
192.168.10.126,65497,79.127.213.243,443,36,11093,813,0,0,22,4492,14,6601,462.349341,15.884896,2262,3324,Google
192.168.10.126,65498,192.168.10.1,53,15,1080,814,0,0,10,652,5,428,470.732415,0.025708,202894,133188,Admin
192.168.10.126,65499,192.168.10.1,53,15,1060,815,0,0,10,652,5,408,470.732586,0.028583,182486,114193,Admin
192.168.10.126,65500,192.168.10.1,53,17,1188,816,0,0,12,760,5,428,470.732708,0.025406,239313,134771,Admin
192.168.10.126,65501,79.127.213.243,443,34,8620,817,0,0,22,3148,12,5472,470.967614,12.274672,2051,3566,Google
192.168.10.126,65502,192.168.10.1,53,15,1068,818,0,0,10,652,5,416,472.20879,0.032178,162098,103424,Admin
192.168.10.126,65503,192.168.10.1,53,17,1168,819,0,0,12,760,5,408,472.209146,0.031817,191092,102586,Admin
192.168.10.126,65504,192.168.10.1,53,17,1176,820,0,0,12,760,5,416,472.209411,0.026512,229330,125528,Admin
192.168.10.126,65505,10.91.66.245,7680,10,660,821,0,0,10,660,0,0,473.678671,15.001301,351,0,Unclear
192.168.10.126,65506,10.91.9.187,7680,10,660,822,0,0,10,660,0,0,473.684054,15.001313,351,0,Unclear
192.168.10.126,65507,79.127.213.244,443,41,9027,823,0,0,26,3348,15,5679,481.211976,11.304236,2369,4019,Google
192.168.10.126,65508,192.168.10.1,53,17,1176,824,0,0,12,760,5,416,483.208398,0.032473,187232,102485,Admin
192.168.10.126,65509,192.168.10.1,53,15,1048,825,0,0,10,652,5,396,483.208827,0.024209,215457,130860,Admin
192.168.10.126,65510,192.168.10.1,53,17,1188,826,0,0,12,760,5,428,483.209137,0.034682,175307,98725,Admin
192.168.10.126,65511,79.127.213.241,443,46,15817,827,0,0,28,7612,18,8205,483.233928,10.993834,5539,5970,Google
192.168.10.126,65512,79.127.213.241,443,26,4633,828,0,0,18,3602,8,1031,486.219478,13.191268,2184,625,Google
192.168.10.126,65513,192.168.10.1,53,15,1025,829,0,0,10,630,5,395,487.223808,0.029282,172119,107916,Admin
192.168.10.126,65514,192.168.10.1,53,17,1121,830,0,0,12,738,5,383,487.224012,0.033516,176154,91419,Admin
192.168.10.126,65515,192.168.10.1,53,17,1238,831,0,0,12,738,5,500,487.224173,0.028907,204241,138374,Admin
192.168.10.126,65516,79.127.213.241,443,33,8573,832,0,0,22,3138,11,5435,487.224799,11.066547,2268,3928,Google
192.168.10.126,65517,192.168.10.1,53,15,1080,833,0,0,10,652,5,428,488.209047,0.026947,193565,127064,Admin
192.168.10.126,65518,192.168.10.1,53,15,1060,834,0,0,10,652,5,408,488.209375,0.029712,175551,109854,Admin
192.168.10.126,65519,192.168.10.1,53,17,1188,835,0,0,12,760,5,428,488.20984,0.030096,202020,113769,Admin
192.168.10.126,65520,192.168.10.1,53,15,1078,836,0,0,10,636,5,442,489.209362,0.02731,186305,129476,Admin
192.168.10.126,65521,192.168.10.1,53,15,1050,837,0,0,10,636,5,414,489.209546,0.026393,192778,125487,Admin
192.168.10.126,65522,192.168.10.1,53,17,1174,838,0,0,12,744,5,430,489.209666,0.028462,209120,120862,Admin
192.168.10.126,65523,192.168.10.1,53,15,1089,839,0,0,10,668,5,421,490.02836,0.020822,256651,161751,Admin
192.168.10.126,65524,192.168.10.1,53,17,1250,840,0,0,12,776,5,474,490.028538,0.023848,260315,159007,Admin
192.168.10.126,65525,192.168.10.1,53,15,1101,841,0,0,10,668,5,433,490.028678,0.022044,242424,157140,Admin
192.168.10.126,65526,3.223.116.153,443,54,14809,842,0,0,34,7508,20,7301,490.048977,62.0833,967,940,Unclear
192.168.10.126,65527,3.223.116.153,443,31,9117,843,0,0,18,2628,13,6489,490.301464,77.907881,269,666,Unclear
192.168.10.126,65532,192.168.10.1,53,15,1083,844,0,0,10,680,5,403,495.733183,0.03346,162582,96353,Admin
192.168.10.126,65533,192.168.10.1,53,17,1191,845,0,0,12,788,5,403,495.733847,0.032906,191576,97976,Admin
192.168.10.126,65534,192.168.10.1,53,15,1121,846,0,0,10,680,5,441,495.734108,0.032645,166641,108071,Admin
192.168.10.126,49152,192.168.10.1,53,15,1075,847,0,0,10,634,5,441,496.23102,0.11256,45060,31343,Admin
192.168.10.126,49153,192.168.10.1,53,15,1059,848,0,0,10,634,5,425,496.231458,0.112416,45118,30244,Admin
192.168.10.126,49154,192.168.10.1,53,17,1121,849,0,0,12,742,5,379,496.231639,0.112236,52888,27014,Admin
192.168.10.126,49155,192.168.10.1,53,15,1063,850,0,0,10,626,5,437,496.716502,0.144149,34741,24252,Admin
192.168.10.126,49156,192.168.10.1,53,15,1127,851,0,0,10,626,5,501,496.717337,0.156478,32004,25613,Admin
192.168.10.126,49157,192.168.10.1,53,17,1116,852,0,0,12,734,5,382,496.718319,0.155495,37763,19653,Admin
192.168.10.126,49158,79.127.213.241,443,29,6187,853,0,0,20,5094,9,1093,498.212833,11.045803,3689,791,Google
192.168.10.126,49159,79.127.213.241,443,37,9285,854,0,0,24,3304,13,5981,499.208604,6.157409,4292,7770,Google
192.168.10.126,49160,192.168.10.1,53,15,1018,855,0,0,10,636,5,382,503.209638,0.169623,29995,18016,Admin
192.168.10.126,49161,192.168.10.1,53,15,982,856,0,0,10,636,5,346,503.209844,0.154724,32884,17889,Admin
192.168.10.126,49162,192.168.10.1,53,16,1084,857,0,0,12,744,4,340,503.210007,0.150235,39617,18104,Admin
192.168.10.126,49163,79.127.213.241,443,26,4633,858,0,0,18,3602,8,1031,505.213251,5.04552,5711,1634,Google
192.168.10.126,49164,79.127.213.244,443,145,61037,859,0,0,92,29944,53,31093,508.242503,65.421082,3661,3802,Google
192.168.10.126,49165,79.127.213.241,443,67,25258,860,0,0,42,10960,25,14298,509.220138,32.04918,2735,3569,Google
192.168.10.126,49166,79.127.213.241,443,55,17049,861,0,0,34,7876,21,9173,510.21501,20.031582,3145,3663,Google
192.168.10.126,49167,52.20.78.240,443,59,14980,862,0,0,40,9062,19,5918,513.122056,57.600659,1258,821,Unclear
192.168.10.126,49168,10.91.48.133,7680,4,264,863,0,0,4,264,0,0,513.679962,1.000026,2111,0,Unclear
192.168.10.126,49169,10.91.222.184,7680,4,264,864,0,0,4,264,0,0,513.686824,0.999595,2112,0,Unclear
192.168.10.126,49170,192.168.10.1,53,15,1074,865,0,0,10,630,5,444,513.997545,0.061925,81388,57359,Admin
192.168.10.126,49171,192.168.10.1,53,17,1193,866,0,0,12,738,5,455,513.997699,0.027194,217106,133853,Admin
192.168.10.126,49172,192.168.10.1,53,15,1086,867,0,0,10,630,5,456,513.997804,0.028739,175371,126935,Admin
192.168.10.126,49173,192.168.10.1,53,15,1135,868,0,0,10,674,5,461,513.998166,0.028402,189845,129850,Admin
192.168.10.126,49174,192.168.10.1,53,15,1119,869,0,0,10,674,5,445,513.998331,0.028242,190921,126053,Admin
192.168.10.126,49175,192.168.10.1,53,17,1188,870,0,0,12,782,5,406,513.998466,0.033437,187098,97137,Admin
192.168.10.126,49176,192.168.10.1,53,15,1172,871,0,0,10,662,5,510,515.250435,0.433814,12207,9404,Admin
192.168.10.126,49177,192.168.10.1,53,17,1244,872,0,0,12,770,5,474,515.250746,0.433724,14202,8742,Admin
192.168.10.126,49178,192.168.10.1,53,15,1161,873,0,0,10,662,5,499,515.250944,0.432635,12241,9227,Admin
192.168.10.126,49179,79.127.213.241,443,68,23311,874,0,0,44,12948,24,10363,515.285588,45.946339,2254,1804,Google
192.168.10.126,49180,79.127.213.244,443,36,11073,875,0,0,22,4460,14,6613,515.317154,20.935148,1704,2527,Google
192.168.10.126,49181,192.168.10.1,53,17,1281,876,0,0,12,776,5,505,515.318225,0.3784,16405,10676,Admin
192.168.10.126,49182,192.168.10.1,53,17,1257,877,0,0,12,776,5,481,515.31948,0.375527,16531,10246,Admin
192.168.10.126,49183,192.168.10.1,53,17,1294,878,0,0,12,776,5,518,515.320959,0.383996,16166,10791,Admin
192.168.10.126,49184,192.168.10.1,53,19,1284,879,0,0,12,760,7,524,515.434605,0.729975,8329,5742,Admin
192.168.10.126,49185,192.168.10.1,53,15,1060,880,0,0,10,652,5,408,515.434974,0.277322,18808,11769,Admin
192.168.10.126,49186,192.168.10.1,53,15,1080,881,0,0,10,652,5,428,515.435383,0.269648,19343,12698,Admin
192.168.10.126,49187,192.168.10.1,53,19,1253,882,0,0,12,738,7,515,515.440543,0.724037,8154,5690,Admin
192.168.10.126,49188,192.168.10.1,53,19,1217,883,0,0,12,738,7,479,515.440818,0.715648,8249,5354,Admin
192.168.10.126,49189,192.168.10.1,53,19,1358,884,0,0,12,738,7,620,515.441023,0.721265,8185,6876,Admin
192.168.10.126,49190,192.168.10.1,53,19,1370,885,0,0,12,760,7,610,515.455169,0.701011,8673,6961,Admin
192.168.10.126,49191,192.168.10.1,53,19,1346,886,0,0,12,760,7,586,515.455416,0.706872,8601,6632,Admin
192.168.10.126,49192,192.168.10.1,53,21,1479,887,0,0,14,868,7,611,515.455559,0.708931,9795,6894,Admin
192.168.10.126,49193,79.127.213.244,443,42,8340,888,0,0,26,2304,16,6036,515.568243,15.651879,1177,3085,Google
2406:3003:2003:1c3b:dd11:a88e:d7a1:7c72,49194,2603:1063:2000:1::12,443,50,22516,889,0,0,34,14308,16,8208,515.669642,57.994015,1973,1132,Google
192.168.10.126,49195,192.168.10.1,53,20,1450,890,0,0,14,956,6,494,515.703589,0.461932,16556,8555,Admin
192.168.10.126,49196,192.168.10.1,53,20,1430,891,0,0,14,956,6,474,515.70395,0.461557,16570,8215,Admin
192.168.10.126,49197,192.168.10.1,53,7,462,892,0,0,2,132,5,330,515.70417,94.318715,11,27,Admin
2406:3003:2003:1c3b:dd11:a88e:d7a1:7c72,49198,2603:1063:2000:1::12,443,32,11429,893,0,0,18,3402,14,8027,515.713763,57.949264,469,1108,Google
192.168.10.126,49199,192.168.10.1,53,17,1145,894,0,0,12,738,5,407,515.788056,0.401974,14687,8100,Admin
192.168.10.126,49200,192.168.10.1,53,17,1121,895,0,0,12,738,5,383,515.788421,0.401321,14711,7634,Admin
192.168.10.126,49201,192.168.10.1,53,17,1250,896,0,0,12,738,5,512,515.788618,0.401081,14720,10212,Admin
2406:3003:2003:1c3b:dd11:a88e:d7a1:7c72,49202,2603:1063:2000:1::12,443,51,18523,897,0,0,32,8860,19,9663,515.965771,57.69763,1228,1339,Google
192.168.10.126,49203,52.108.9.12,443,6,380,898,0,0,2,132,4,248,516.014162,2.809688,375,706,Unclear
2406:3003:2003:1c3b:dd11:a88e:d7a1:7c72,49204,2603:1063:2000:1::12,443,23,10649,899,0,0,12,2868,11,7781,516.014558,0.173023,132606,359767,Google
192.168.10.126,49205,192.168.10.1,53,8,528,900,0,0,2,132,6,396,516.138322,95.283361,11,33,Admin
2406:3003:2003:1c3b:dd11:a88e:d7a1:7c72,49206,2406:3003:2003:1c3b:5aef:68ff:febf:8de0,53,2,172,901,0,0,2,172,0,0,516.138552,5.00E-06,,,Google
2406:3003:2003:1c3b:dd11:a88e:d7a1:7c72,49207,2406:3003:2003:1c3b:5aef:68ff:febf:8de0,53,2,172,902,0,0,2,172,0,0,516.1387,3.00E-06,,,Google
192.168.10.126,49208,192.168.10.1,53,17,1150,903,0,0,12,740,5,410,516.162798,0.032845,180240,99862,Admin
192.168.10.126,49209,192.168.10.1,53,17,1126,904,0,0,12,740,5,386,516.163046,0.032498,182165,95021,Admin
192.168.10.126,49210,192.168.10.1,53,17,1243,905,0,0,12,740,5,503,516.163254,0.032281,183389,124655,Admin
192.168.10.126,49211,79.127.213.244,443,43,11460,906,0,0,28,4808,15,6652,516.20684,13.32551,2886,3993,Google
192.168.10.126,61733,34.149.211.227,443,20,3910,100,0,0,12,2620,8,1290,516.219817,231.650522,90,44,Unclear
192.168.10.126,61747,34.149.211.227,443,24,5716,101,0,0,14,4166,10,1550,516.275125,231.945974,143,53,Unclear
192.168.10.126,49212,192.168.10.1,53,17,1247,907,0,0,12,780,5,467,517.210767,0.025853,241364,144509,Admin
192.168.10.126,49213,192.168.10.1,53,17,1223,908,0,0,12,780,5,443,517.211056,0.028343,220160,125039,Admin
192.168.10.126,49214,192.168.10.1,53,17,1315,909,0,0,12,780,5,535,517.211232,0.028185,221394,151853,Admin
192.168.10.126,49215,40.79.141.153,443,50,20478,910,0,0,34,12666,16,7812,517.913268,55.685895,1819,1122,
192.168.10.126,49216,192.168.10.1,53,15,1046,911,0,0,10,636,5,410,518.209362,0.020169,252268,162625,Admin
192.168.10.126,49217,192.168.10.1,53,17,1154,912,0,0,12,744,5,410,518.209527,0.021766,273454,150693,Admin
192.168.10.126,49218,192.168.10.1,53,17,1183,913,0,0,12,744,5,439,518.209637,0.025007,238013,140440,Admin
192.168.10.126,49219,10.97.139.191,7680,8,528,914,0,0,8,528,0,0,519.757219,7.003039,603,0,Unclear
192.168.10.126,49220,10.91.34.37,7680,8,528,915,0,0,8,528,0,0,519.757837,7.001271,603,0,Unclear
192.168.10.126,49221,192.168.10.1,53,17,1099,916,0,0,12,742,5,357,527.209957,0.029709,199804,96132,Admin
192.168.10.126,49222,192.168.10.1,53,15,979,917,0,0,10,634,5,345,527.210209,0.029686,170854,92973,Admin
192.168.10.126,49223,192.168.10.1,53,14,966,918,0,0,10,634,4,332,527.21037,0.029498,171943,90040,Admin
192.168.10.126,49224,79.127.213.244,443,33,4971,919,0,0,22,3782,11,1189,529.22189,11.305039,2676,841,Google
192.168.10.126,49225,79.127.213.244,443,39,9271,920,0,0,24,3276,15,5995,529.223025,11.296171,2320,4245,Google
192.168.10.126,49226,79.127.213.244,443,32,8542,921,0,0,20,3036,12,5506,529.223852,22.006353,1103,2001,Google
192.168.10.126,49227,192.168.10.1,53,17,1188,922,0,0,12,760,5,428,536.208366,0.028435,213820,120414,Admin
192.168.10.126,49228,192.168.10.1,53,17,1168,923,0,0,12,760,5,408,536.208596,0.036971,164453,88285,Admin
192.168.10.126,49229,192.168.10.1,53,15,1080,924,0,0,10,652,5,428,536.208731,0.036523,142814,93749,Admin
192.168.10.126,49230,79.127.213.240,443,32,8498,925,0,0,20,3024,12,5474,536.240672,11.187567,2162,3914,Google
192.168.10.126,49231,79.127.213.241,443,34,8721,926,0,0,22,3248,12,5473,537.904099,12.370794,2100,3539,Google
192.168.10.126,49232,10.91.22.104,7680,10,660,927,0,0,10,660,0,0,538.768476,15.003524,351,0,Unclear
192.168.10.126,49233,10.91.218.213,7680,10,660,928,0,0,10,660,0,0,538.769598,15.014533,351,0,Unclear
192.168.10.126,49234,192.168.10.1,53,15,1140,929,0,0,10,670,5,470,539.165797,0.029564,181301,127181,Admin
192.168.10.126,49235,192.168.10.1,53,17,1236,930,0,0,12,778,5,458,539.166021,0.029341,212126,124876,Admin
192.168.10.126,49236,192.168.10.1,53,17,1268,931,0,0,12,778,5,490,539.166174,0.038605,161222,101541,Admin
2406:3003:2003:1c3b:dd11:a88e:d7a1:7c72,49237,2600:1413:a000::172f:be78,443,56,10632,932,0,0,34,6986,22,3646,539.194802,34.469635,1621,846,Google
192.168.10.126,49238,192.168.10.1,53,17,1188,933,0,0,12,760,5,428,541.214107,0.038388,158382,89194,Admin
192.168.10.126,49239,192.168.10.1,53,17,1168,934,0,0,12,760,5,408,541.214284,0.038212,159112,85418,Admin
192.168.10.126,49240,192.168.10.1,53,17,1188,935,0,0,12,760,5,428,541.214432,0.037588,161753,91092,Admin
192.168.10.126,49241,79.127.213.240,443,33,8556,936,0,0,20,3030,13,5526,541.243273,11.060543,2191,3996,Google
192.168.10.126,49242,192.168.10.1,53,24,1578,937,0,0,16,976,8,602,548.503454,0.357195,21859,13482,Admin
192.168.10.126,49243,192.168.10.1,53,24,1558,938,0,0,16,976,8,582,548.504139,0.35651,21901,13059,Admin
192.168.10.126,49244,192.168.10.1,53,23,1524,939,0,0,16,976,7,548,548.504286,0.3554,21969,12335,Admin
192.168.10.126,49245,192.168.10.1,53,15,1095,940,0,0,10,680,5,415,549.791104,0.039097,139141,84917,Admin
192.168.10.126,49246,192.168.10.1,53,17,1191,941,0,0,12,788,5,403,549.791261,0.038971,161761,82728,Admin
192.168.10.126,49247,192.168.10.1,53,17,1232,942,0,0,12,788,5,444,549.791369,0.038804,162457,91536,Admin
192.168.10.126,49248,192.168.10.1,53,15,1128,943,0,0,10,664,5,464,550.005632,0.037916,140099,97900,Admin
192.168.10.126,49249,192.168.10.1,53,15,1115,944,0,0,10,664,5,451,550.005819,0.044938,118207,80288,Admin
192.168.10.126,49250,192.168.10.1,53,17,1236,945,0,0,12,772,5,464,550.005951,0.037569,164390,98804,Admin
192.168.10.126,49251,13.227.254.37,443,29,6595,946,0,0,20,5280,9,1315,550.044245,23.620265,1788,445,Google
192.168.10.126,49252,192.168.10.1,53,15,1080,947,0,0,10,652,5,428,550.212611,0.044793,116446,76440,Admin
192.168.10.126,49253,192.168.10.1,53,17,1168,948,0,0,12,760,5,408,550.21297,0.047094,129103,69308,Admin
192.168.10.126,49254,192.168.10.1,53,17,1188,949,0,0,12,760,5,428,550.213267,0.046797,129922,73167,Admin
192.168.10.126,49255,192.168.10.1,53,17,1174,950,0,0,12,744,5,430,551.207662,0.046023,129326,74745,Admin
192.168.10.126,49256,192.168.10.1,53,17,1158,951,0,0,12,744,5,414,551.207963,0.038186,155868,86733,Admin
192.168.10.126,49257,192.168.10.1,53,17,1174,952,0,0,12,744,5,430,551.208178,0.03143,189373,109449,Admin
192.168.10.126,49258,79.127.213.244,443,35,9697,953,0,0,22,3144,13,6553,551.21367,22.435437,1121,2336,Google
192.168.10.126,49259,79.127.213.244,443,51,17199,954,0,0,32,7728,19,9471,551.215506,32.011887,1931,2366,Google
192.168.10.126,49260,79.127.213.244,443,38,11183,955,0,0,24,4592,14,6591,551.215865,19.038598,1929,2769,Google
192.168.10.126,49261,79.127.213.240,443,145,56411,956,0,0,92,31050,53,25361,552.209524,83.070257,2990,2442,Google
192.168.10.126,49262,192.168.10.1,53,17,1219,957,0,0,12,766,5,453,552.29764,0.043812,139870,82717,Admin
192.168.10.126,49263,192.168.10.1,53,17,1159,958,0,0,12,766,5,393,552.29788,0.043548,140718,72196,Admin
192.168.10.126,49264,192.168.10.1,53,17,1308,959,0,0,12,766,5,542,552.298038,0.04341,141165,99884,Admin
192.168.10.126,49265,79.127.213.241,443,35,9795,960,0,0,22,3248,13,6547,561.209527,12.452104,2086,4206,Google
192.168.10.126,49266,79.127.213.241,443,62,21364,961,0,0,36,9352,26,12012,561.211071,25.056105,2985,3835,Google
192.168.10.126,49267,192.168.10.1,53,15,1030,962,0,0,10,636,5,394,564.208358,0.024212,210143,130183,Admin
192.168.10.126,49268,192.168.10.1,53,15,970,963,0,0,10,636,5,334,564.208514,0.017053,298363,156687,Admin
192.168.10.126,49269,192.168.10.1,53,17,1138,964,0,0,12,744,5,394,564.208609,0.025999,228931,121235,Admin
34.120.85.253,443,192.168.10.126,63434,10,588,965,0,0,4,216,6,372,566.212931,0.006841,252594,435024,Admin
192.168.10.126,49270,3.220.57.224,443,55,14598,966,0,0,36,8692,19,5906,570.533961,60.473903,1149,781,Unclear
192.168.10.126,49271,79.127.213.240,443,43,11460,967,0,0,28,4786,15,6674,575.22962,58.013681,659,920,Google
2406:3003:2003:1c3b:dd11:a88e:d7a1:7c72,49272,2603:1063:2000:1::12,443,39,11999,968,0,0,24,4470,15,7529,575.233899,18.423542,1940,3269,Google
2406:3003:2003:1c3b:dd11:a88e:d7a1:7c72,49273,2603:1063:2200:20::2f,443,56,28256,969,0,0,42,14740,14,13516,575.234367,18.648914,6323,5798,Google
2406:3003:2003:1c3b:dd11:a88e:d7a1:7c72,49274,2603:1063:2200:20::2f,443,58,28404,970,0,0,44,14888,14,13516,575.236709,18.639269,6389,5801,Google
192.168.10.126,49275,79.127.213.244,443,58,19432,971,0,0,38,9488,20,9944,575.252865,24.078938,3152,3303,Google
192.168.10.126,49276,79.127.213.244,443,35,9688,972,0,0,22,3258,13,6430,575.255173,18.402011,1416,2795,Google
2406:3003:2003:1c3b:dd11:a88e:d7a1:7c72,49277,2606:4700:3110::6812:336a,443,26,7769,973,0,0,16,1846,10,5923,575.258434,16.963926,870,2793,Google
192.168.10.126,49278,192.168.10.1,53,17,1282,974,0,0,12,778,5,504,575.394307,0.023596,263773,170876,Admin
192.168.10.126,49279,192.168.10.1,53,15,1126,975,0,0,10,670,5,456,575.394525,0.023141,231623,157642,Admin
192.168.10.126,49280,192.168.10.1,53,17,1294,976,0,0,12,778,5,516,575.394675,0.02299,270726,179556,Admin
192.168.10.126,49281,20.42.72.131,443,57,26020,977,0,0,40,18112,17,7908,575.415133,18.813747,7701,3362,Unclear
192.168.10.126,49282,20.42.72.131,443,13,1879,978,0,0,10,1606,3,273,575.716499,0.670817,19152,3255,Unclear
192.168.10.126,49283,68.232.45.61,443,69,19288,979,0,0,46,8244,23,11044,576.208609,17.447697,3779,5063,Unclear
192.168.10.126,49284,79.127.213.241,443,45,14508,980,0,0,28,6160,17,8348,577.738695,15.918944,3095,4195,Google
192.168.10.126,49285,192.168.10.1,53,17,1247,981,0,0,12,780,5,467,579.211915,0.034859,179006,107174,Admin
192.168.10.126,49286,192.168.10.1,53,15,1127,982,0,0,10,672,5,455,579.212213,0.034561,155551,105321,Admin
192.168.10.126,49287,192.168.10.1,53,17,1315,983,0,0,12,780,5,535,579.212354,0.034396,181416,124433,Admin
192.168.10.126,49288,192.168.10.1,53,15,1058,984,0,0,10,636,5,422,581.210901,0.235146,21637,14357,Admin
192.168.10.126,49289,192.168.10.1,53,17,1142,985,0,0,12,744,5,398,581.211162,0.234883,25340,13555,Admin
192.168.10.126,49290,192.168.10.1,53,17,1195,986,0,0,12,744,5,451,581.211312,0.218477,27243,16514,Admin
192.168.10.126,49291,192.168.10.1,53,15,1080,987,0,0,10,652,5,428,583.212219,0.026646,195751,128499,Admin
192.168.10.126,49292,192.168.10.1,53,17,1156,988,0,0,12,760,5,396,583.212553,0.032006,189964,98981,Admin
192.168.10.126,49293,192.168.10.1,53,17,1188,989,0,0,12,760,5,428,583.212791,0.030087,202080,113803,Admin
192.168.10.126,49294,79.127.213.241,443,34,8634,990,0,0,22,3144,12,5490,583.239282,2.994877,8398,14665,Google
192.168.10.126,49295,79.127.213.241,443,41,11609,991,0,0,26,4800,15,6809,583.239418,10.417871,3685,5228,Google
192.168.10.126,49296,79.127.213.241,443,35,9680,992,0,0,22,3144,13,6536,583.239535,10.417649,2414,5019,Google
192.168.10.126,49297,79.127.213.241,443,39,11254,993,0,0,24,4592,15,6662,583.239653,16.121672,2278,3305,Google
192.168.10.126,49298,79.127.213.241,443,39,12371,994,0,0,24,4700,15,7671,587.826467,15.8274,2375,3877,Google
34.120.85.253,443,192.168.10.126,63433,9,534,995,0,0,3,162,6,372,592.890746,0.005587,231967,532665,Admin
192.168.10.126,49299,79.127.213.241,443,38,10877,996,0,0,24,4700,14,6177,594.24308,15.986596,2351,3091,Google
192.168.10.126,49300,68.232.45.61,443,44,13915,997,0,0,30,6434,14,7481,596.20807,7.446816,6911,8036,Unclear
192.168.10.126,49301,192.168.10.1,53,15,1051,998,0,0,10,626,5,425,599.084115,0.025358,197491,134079,Admin
192.168.10.126,49302,192.168.10.1,53,15,1127,999,0,0,10,626,5,501,599.084279,0.030094,166411,133182,Admin
192.168.10.126,49303,192.168.10.1,53,17,1116,1000,0,0,12,734,5,382,599.084407,0.029966,195955,101982,Admin
192.168.10.126,49304,79.127.213.241,443,34,8634,1001,0,0,22,3144,12,5490,599.212251,1.070792,23489,41016,Google
192.168.10.126,49305,79.127.213.244,443,43,12492,1002,0,0,28,4816,15,7676,599.214875,4.438992,8679,13833,Google
192.168.10.126,49306,192.168.10.1,53,15,1025,1003,0,0,10,630,5,395,599.215247,0.172543,29210,18314,Admin
192.168.10.126,49307,192.168.10.1,53,17,1121,1004,0,0,12,738,5,383,599.215354,0.17256,34214,17756,Admin
192.168.10.126,49308,192.168.10.1,53,18,1292,1005,0,0,12,738,6,554,599.215446,0.172344,34257,25716,Admin
192.168.10.126,49309,79.127.213.241,443,37,9819,1006,0,0,24,3252,13,6567,600.21022,3.44663,7548,15242,Google
192.168.10.126,49310,79.127.213.241,443,29,7109,1007,0,0,18,1688,11,5421,600.212073,3.443058,3922,12595,Google
192.168.10.126,49311,79.127.213.241,443,41,11360,1008,0,0,26,4700,15,6660,600.213644,12.051798,3119,4420,Google
192.168.10.126,49312,79.127.213.241,443,35,9695,1009,0,0,22,3144,13,6551,600.215304,3.444653,7301,15214,Google
192.168.10.126,49313,79.127.213.241,443,35,9696,1010,0,0,22,3144,13,6552,600.216617,3.438683,7314,15243,Google
192.168.10.126,49314,68.232.45.61,443,9382,10135108,1011,0,0,2532,167712,6850,9967396,604.207958,169.497767,7915,470443,Unclear
192.168.10.126,49315,79.127.213.244,443,164,68343,1012,0,0,108,36212,56,32131,604.209261,98.019856,2955,2622,Google
192.168.10.126,49316,192.168.10.1,53,2,132,1013,0,0,2,132,0,0,607.210926,1.00E-05,,,Admin
192.168.10.126,49317,192.168.10.1,53,17,1156,1014,0,0,12,760,5,396,607.211204,0.030218,201204,104838,Admin
192.168.10.126,49318,192.168.10.1,53,15,1080,1015,0,0,10,652,5,428,607.211491,0.029932,174261,114392,Admin
192.168.10.126,49319,192.168.10.1,53,20,1350,1016,0,0,14,868,6,482,607.647003,0.275673,25189,13987,Admin
192.168.10.126,49320,192.168.10.1,53,15,1080,1017,0,0,10,652,5,428,610.210875,0.022766,229113,150399,Admin
192.168.10.126,49321,192.168.10.1,53,17,1168,1018,0,0,12,760,5,408,610.211105,0.02383,255140,136970,Admin
192.168.10.126,49322,192.168.10.1,53,17,1188,1019,0,0,12,760,5,428,610.211296,0.02364,257191,144839,Admin
192.168.10.126,49323,79.127.213.244,443,40,11414,1020,0,0,26,4808,14,6606,610.229973,23.02161,1670,2295,Google
192.168.10.126,49324,79.127.213.244,443,79,29435,1021,0,0,50,15236,29,14199,610.230088,57.027674,2137,1991,Google
192.168.10.126,49325,79.127.213.241,443,36,8726,1022,0,0,24,3252,12,5474,612.2102,1.03477,25141,42320,Google
192.168.10.126,49326,192.168.10.1,53,15,1078,1023,0,0,10,636,5,442,612.211926,0.024714,205875,143076,Admin
192.168.10.126,49327,192.168.10.1,53,17,1146,1024,0,0,12,744,5,402,612.212081,0.023454,253773,137119,Admin
192.168.10.126,49328,192.168.10.1,53,15,1066,1025,0,0,10,636,5,430,612.212203,0.021106,241068,162986,Admin
192.168.10.126,49329,79.127.213.241,443,26,4597,1026,0,0,18,3566,8,1031,613.216141,1.031578,27654,7995,Google
192.168.10.126,49330,79.127.213.241,443,42,9065,1027,0,0,26,3360,16,5705,613.217305,9.511426,2826,4798,Google
192.168.10.126,49334,192.168.10.1,53,15,1080,1028,0,0,10,652,5,428,614.209612,0.047172,110574,72585,Admin
192.168.10.126,49335,192.168.10.1,53,17,1168,1029,0,0,12,760,5,408,614.209746,0.047068,129174,69346,Admin
192.168.10.126,49336,192.168.10.1,53,15,1068,1030,0,0,10,652,5,416,614.209857,0.047014,110945,70787,Admin
192.168.10.126,49338,10.91.174.177,7680,10,660,1031,0,0,10,660,0,0,616.227802,15.002033,351,0,Unclear
192.168.10.126,49339,10.91.94.67,7680,10,660,1032,0,0,10,660,0,0,616.228574,15.001854,351,0,Unclear
192.168.10.126,49340,79.127.213.241,443,35,7095,1033,0,0,24,5370,11,1725,622.209931,2.028561,21177,6802,Google
192.168.10.126,49341,192.168.10.1,53,15,1080,1034,0,0,10,652,5,428,623.053372,0.067874,76848,50446,Admin
192.168.10.126,49342,192.168.10.1,53,17,1168,1035,0,0,12,760,5,408,623.053488,0.066547,91363,49048,Admin
192.168.10.126,49343,192.168.10.1,53,17,1188,1036,0,0,12,760,5,428,623.053583,0.067664,89855,50602,Admin
192.168.10.126,49344,79.127.213.241,443,26,4613,1037,0,0,18,3598,8,1015,624.218358,1.025002,28081,7921,Google
192.168.10.126,49345,79.127.213.241,443,36,8758,1038,0,0,24,3252,12,5506,624.219111,9.027089,2881,4879,Google
192.168.10.126,49346,192.168.10.1,53,15,1030,1039,0,0,10,636,5,394,627.211712,0.028956,175714,108854,Admin
192.168.10.126,49347,192.168.10.1,53,15,970,1040,0,0,10,636,5,334,627.211896,0.0228,223157,117192,Admin
192.168.10.126,49348,192.168.10.1,53,17,1126,1041,0,0,12,744,5,382,627.212043,0.032303,184255,94604,Admin
192.168.10.126,49349,69.165.105.13,443,50,12859,1042,0,0,34,9066,16,3793,627.238923,146.703909,494,206,Unclear
192.168.10.126,49350,52.143.87.28,443,36,7799,1043,0,0,26,4148,10,3651,629.879277,63.540337,522,459,Unclear
192.168.10.126,61744,34.149.211.227,443,21,4158,104,0,0,12,2666,9,1492,630.052795,117.922095,180,101,Unclear
192.168.10.126,61739,34.149.211.227,443,28,10058,103,0,0,16,7876,12,2182,630.233269,164.615338,382,106,Unclear
192.168.10.126,49351,34.120.85.253,443,39,14984,1044,0,0,26,9372,13,5612,630.702163,164.403772,456,273,Unclear
192.168.10.126,49352,192.168.10.1,53,17,1194,1045,0,0,12,738,5,456,630.727344,0.039627,148989,92058,Admin
192.168.10.126,49353,192.168.10.1,53,17,1193,1046,0,0,12,738,5,455,630.727509,0.289572,20388,12570,Admin
192.168.10.126,49354,192.168.10.1,53,18,1248,1047,0,0,12,738,6,510,630.727622,0.28082,21024,14528,Admin
192.168.10.126,49355,52.20.78.240,443,57,14706,1048,0,0,38,8800,19,5906,631.00994,59.935695,1174,788,Unclear
192.168.10.126,49356,192.168.10.1,53,15,994,1049,0,0,10,636,5,358,631.21796,0.023093,220326,124020,Admin
192.168.10.126,49357,192.168.10.1,53,15,970,1050,0,0,10,636,5,334,631.218195,0.019104,266331,139865,Admin
192.168.10.126,49358,192.168.10.1,53,17,1153,1051,0,0,12,744,5,409,631.218366,0.023053,258187,141933,Admin
2406:3003:2003:1c3b:dd11:a88e:d7a1:7c72,49359,2001:67c:4e8:f004::9,443,49,13313,1052,0,0,32,5448,17,7865,631.237938,142.63732,305,441,Unclear
192.168.10.126,49360,52.20.78.240,443,71,25026,1053,0,0,48,13822,23,11204,631.757298,142.175934,777,630,Unclear
192.168.10.126,49361,52.20.78.240,443,61,17810,1054,0,0,40,9132,21,8678,632.488961,141.44436,516,490,Unclear
192.168.10.126,49362,52.20.78.240,443,70,21913,1055,0,0,46,11600,24,10313,632.489731,141.437142,656,583,Unclear
192.168.10.126,49363,79.127.213.241,443,27,4667,1056,0,0,18,3598,9,1069,633.212297,2.13788,13463,4000,Google
192.168.10.126,49364,79.127.213.241,443,95,41145,1057,0,0,54,20844,41,20301,633.21467,73.233163,2277,2217,Google
192.168.10.126,49365,79.127.213.243,443,65,21821,1058,0,0,42,9582,23,12239,635.218771,138.483981,553,707,Google
192.168.10.126,49366,192.168.10.1,53,17,1293,1059,0,0,12,776,5,517,635.227439,0.136755,45395,30243,Admin
192.168.10.126,49367,192.168.10.1,53,17,1269,1060,0,0,12,776,5,493,635.229106,0.140555,44167,28060,Admin
192.168.10.126,49368,192.168.10.1,53,17,1294,1061,0,0,12,776,5,518,635.230691,0.140552,44168,29483,Admin
192.168.10.126,49369,192.168.10.1,53,17,1139,1062,0,0,12,746,5,393,635.236127,0.129402,46119,24296,Admin
192.168.10.126,49370,192.168.10.1,53,17,1093,1063,0,0,12,746,5,347,635.236473,0.134017,44531,20713,Admin
192.168.10.126,49371,192.168.10.1,53,17,1139,1064,0,0,12,746,5,393,635.236752,0.128446,46463,24477,Admin
192.168.10.126,49372,79.127.213.241,443,34,8651,1065,0,0,22,3144,12,5507,635.252885,1.042391,24129,42264,Google
192.168.10.126,49373,192.168.10.1,53,15,1033,1066,0,0,10,662,5,371,635.253959,0.130321,40638,22774,Admin
192.168.10.126,49374,192.168.10.1,53,17,1129,1067,0,0,12,770,5,359,635.254324,0.115828,53182,24795,Admin
192.168.10.126,49375,192.168.10.1,53,17,1163,1068,0,0,12,770,5,393,635.254515,0.135437,45482,23213,Admin
192.168.10.126,49376,79.127.213.241,443,42,13662,1069,0,0,26,5940,16,7722,635.261982,25.964429,1830,2379,Google
192.168.10.126,49377,79.127.213.241,443,53,17620,1070,0,0,34,7736,19,9884,635.266448,25.010691,2474,3161,Google
192.168.10.126,49378,192.168.10.1,53,15,1075,1071,0,0,10,634,5,441,635.272454,0.118294,42876,29823,Admin
192.168.10.126,49379,192.168.10.1,53,17,1167,1072,0,0,12,742,5,425,635.272788,0.119873,49519,28363,Admin
192.168.10.126,49380,192.168.10.1,53,15,1013,1073,0,0,10,634,5,379,635.273129,0.117024,43341,25909,Admin
2406:3003:2003:1c3b:dd11:a88e:d7a1:7c72,49381,2603:1063:2000::12,443,61,21936,1074,0,0,38,9146,23,12790,635.349063,138.357292,528,739,Google
192.168.10.126,49382,34.107.199.61,443,42,8973,1075,0,0,26,3468,16,5505,635.352743,34.719292,799,1268,Unclear
192.168.10.126,49383,192.168.10.1,53,17,1150,1076,0,0,12,740,5,410,635.359232,0.046308,127839,70830,Admin
192.168.10.126,49384,192.168.10.1,53,17,1126,1077,0,0,12,740,5,386,635.360203,0.047011,125927,65686,Admin
192.168.10.126,49385,192.168.10.1,53,17,1255,1078,0,0,12,740,5,515,635.361058,0.046355,127710,88879,Admin
192.168.10.126,61809,34.149.211.227,443,25,5075,149,0,0,16,3190,9,1885,635.371709,159.477044,160,94,Unclear
192.168.10.126,49386,20.42.72.131,443,115,52973,1079,0,0,84,43876,31,9097,635.389371,138.543634,2533,525,Unclear
2406:3003:2003:1c3b:dd11:a88e:d7a1:7c72,49387,2404:6800:4003:c1c::5f,443,36,13211,1080,0,0,22,2324,14,10887,635.39472,88.405905,210,985,Google
192.168.10.126,49388,192.168.10.1,53,17,1280,1081,0,0,12,770,5,510,635.406116,0.027578,223366,147944,Admin
192.168.10.126,49389,192.168.10.1,53,17,1256,1082,0,0,12,770,5,486,635.406314,0.029634,207869,131200,Admin
192.168.10.126,49390,192.168.10.1,53,17,1281,1083,0,0,12,770,5,511,635.406461,0.03146,195804,129942,Admin
192.168.10.126,61742,34.149.211.227,443,10,1977,174,0,0,6,1344,4,633,635.408241,0.090976,118185,55663,Unclear
2406:3003:2003:1c3b:dd11:a88e:d7a1:7c72,49391,2603:1063:2200:30::40,443,35,11365,1084,0,0,24,4462,11,6903,635.41612,124.749203,286,442,Google
2406:3003:2003:1c3b:dd11:a88e:d7a1:7c72,49392,2603:1063:2000:1::12,443,88,47047,1085,0,0,60,35546,28,11501,635.434479,138.272003,2056,665,Google
192.168.10.126,61808,34.149.211.227,443,16,8783,26,0,0,10,8010,6,773,635.45823,0.084683,756704,73025,Unclear
2406:3003:2003:1c3b:dd11:a88e:d7a1:7c72,49393,2603:1063:2200:30::40,443,128,73196,1086,0,0,96,40338,32,32858,635.529582,138.344385,2332,1900,Google
2406:3003:2003:1c3b:dd11:a88e:d7a1:7c72,49394,2603:1063:2200:30::40,443,129,74046,1087,0,0,96,38572,33,35474,635.530226,138.344424,2230,2051,Google
192.168.10.126,61803,34.149.211.227,443,10,2019,30,0,0,6,1386,4,633,635.533479,0.089919,123310,56317,Unclear
192.168.10.126,49395,192.168.10.1,53,17,1291,1088,0,0,12,778,5,513,635.693025,0.022442,277337,182871,Admin
192.168.10.126,49396,192.168.10.1,53,17,1246,1089,0,0,12,778,5,468,635.693205,0.024717,251810,151474,Admin
192.168.10.126,49397,192.168.10.1,53,17,1279,1090,0,0,12,778,5,501,635.693303,0.023377,266244,171450,Admin
192.168.10.126,49398,52.168.112.66,443,13,1879,1091,0,0,10,1606,3,273,635.714032,0.669182,19199,3263,Unclear
192.168.10.126,49399,192.168.10.1,53,15,1025,1092,0,0,10,630,5,395,635.744962,0.02391,210790,132162,Admin
192.168.10.126,49400,192.168.10.1,53,17,1121,1093,0,0,12,738,5,383,635.745118,0.02375,248589,129010,Admin
192.168.10.126,49401,192.168.10.1,53,17,1250,1094,0,0,12,738,5,512,635.74523,0.027635,213642,148217,Admin
2406:3003:2003:1c3b:dd11:a88e:d7a1:7c72,49402,2606:4700:3110::6812:32ad,443,26,7769,1095,0,0,16,1846,10,5923,635.779752,15.47502,954,3061,Google
2406:3003:2003:1c3b:dd11:a88e:d7a1:7c72,49403,2606:4700:3110::6812:32ad,443,28,7917,1096,0,0,18,1994,10,5923,635.780011,15.474761,1030,3062,Google
2406:3003:2003:1c3b:dd11:a88e:d7a1:7c72,49404,2606:4700:3110::6812:32ad,443,26,7769,1097,0,0,16,1846,10,5923,635.780902,15.47387,954,3062,Google
2406:3003:2003:1c3b:dd11:a88e:d7a1:7c72,49405,2606:4700:3110::6812:32ad,443,28,7917,1098,0,0,18,1994,10,5923,635.782001,15.472771,1030,3062,Google
2406:3003:2003:1c3b:dd11:a88e:d7a1:7c72,49406,2606:4700:3110::6812:32ad,443,26,7769,1099,0,0,16,1846,10,5923,635.782255,15.472517,954,3062,Google
192.168.10.126,49407,79.127.213.241,443,56,19680,1100,0,0,34,9300,22,10380,636.701477,23.563356,3157,3524,Google
192.168.10.126,49408,79.127.213.244,443,36,8966,1101,0,0,22,3272,14,5694,638.153551,12.153777,2153,3747,Google
192.168.10.126,49409,192.168.10.1,53,15,1139,1102,0,0,10,672,5,467,640.235514,0.037343,143962,100045,Admin
192.168.10.126,49410,192.168.10.1,53,15,1127,1103,0,0,10,672,5,455,640.235678,0.037179,144597,97904,Admin
192.168.10.126,49411,192.168.10.1,53,17,1315,1104,0,0,12,780,5,535,640.23582,0.037075,168307,115441,Admin
192.168.10.126,49412,192.168.10.1,53,15,1080,1105,0,0,10,652,5,428,644.212302,0.029192,178679,117292,Admin
192.168.10.126,49413,192.168.10.1,53,17,1168,1106,0,0,12,760,5,408,644.212593,0.44442,13680,7344,Admin
192.168.10.126,49414,192.168.10.1,53,17,1188,1107,0,0,12,760,5,428,644.212994,0.444022,13693,7711,Admin
192.168.10.126,49415,192.168.10.1,53,8,528,1108,0,0,2,132,6,396,644.647019,95.565066,11,33,Admin
2406:3003:2003:1c3b:dd11:a88e:d7a1:7c72,49416,2406:3003:2003:1c3b:5aef:68ff:febf:8de0,53,2,172,1109,0,0,2,172,0,0,644.647213,4.00E-06,,,Google
192.168.10.126,49417,192.168.10.1,53,17,1183,1110,0,0,12,742,5,441,646.213254,0.252543,23504,13969,Admin
192.168.10.126,49418,192.168.10.1,53,17,1167,1111,0,0,12,742,5,425,646.21342,0.252383,23519,13471,Admin
192.168.10.126,49419,192.168.10.1,53,17,1121,1112,0,0,12,742,5,379,646.213511,0.252279,23529,12018,Admin
192.168.10.126,49420,192.168.10.1,53,15,991,1113,0,0,10,634,5,357,648.21512,0.053559,94699,53324,Admin
192.168.10.126,49421,192.168.10.1,53,17,1087,1114,0,0,12,742,5,345,648.215287,0.05339,111181,51695,Admin
192.168.10.126,49422,192.168.10.1,53,15,1008,1115,0,0,10,634,5,374,648.215402,0.053298,95163,56137,Admin
192.168.10.126,49423,192.168.10.1,53,15,1095,1116,0,0,10,680,5,415,655.638591,0.031224,174224,106328,Admin
192.168.10.126,49424,192.168.10.1,53,17,1191,1117,0,0,12,788,5,403,655.638825,0.036112,174568,89277,Admin
192.168.10.126,49425,192.168.10.1,53,17,1241,1118,0,0,12,788,5,453,655.638957,0.035981,175203,100719,Admin
192.168.10.126,49426,79.127.213.244,443,37,11159,1119,0,0,22,4492,15,6667,655.782618,22.482726,1598,2372,Google
192.168.10.126,49427,192.168.10.1,53,17,1138,1120,0,0,12,738,5,400,655.867319,0.043027,137216,74371,Admin
192.168.10.126,49428,192.168.10.1,53,17,1126,1121,0,0,12,738,5,388,655.867507,0.051525,114585,60242,Admin
192.168.10.126,49429,192.168.10.1,53,17,1167,1122,0,0,12,738,5,429,655.867657,0.042689,138302,80395,Admin
192.168.10.126,49430,192.168.10.1,53,17,1129,1123,0,0,12,762,5,367,656.146142,0.08093,75324,36278,Admin
192.168.10.126,49431,192.168.10.1,53,15,1009,1124,0,0,10,654,5,355,656.146882,0.080172,65259,35423,Admin
192.168.10.126,49432,192.168.10.1,53,17,1158,1125,0,0,12,762,5,396,656.14847,0.078141,78012,40542,Admin
192.168.10.126,49433,192.168.10.1,53,17,1129,1126,0,0,12,762,5,367,656.167527,0.079945,76252,36725,Admin
192.168.10.126,49434,192.168.10.1,53,17,1117,1127,0,0,12,762,5,355,656.167782,0.066627,91494,42625,Admin
192.168.10.126,49435,192.168.10.1,53,17,1158,1128,0,0,12,762,5,396,656.167961,0.078787,77373,40209,Admin
192.168.10.126,49436,192.168.10.1,53,15,1117,1129,0,0,10,662,5,455,656.198662,0.070914,74682,51329,Admin
192.168.10.126,49437,192.168.10.1,53,17,1165,1130,0,0,12,770,5,395,656.198961,0.070625,87221,44743,Admin
192.168.10.126,49438,192.168.10.1,53,17,1314,1131,0,0,12,770,5,544,656.1991,0.070496,87380,61733,Admin
192.168.10.126,49439,10.96.120.81,7680,10,660,1132,0,0,10,660,0,0,656.230673,15.002122,351,0,Unclear
192.168.10.126,49440,10.91.231.250,7680,10,660,1133,0,0,10,660,0,0,656.231937,15.000858,351,0,Unclear
192.168.10.126,49441,10.91.202.189,7680,10,660,1134,0,0,10,660,0,0,656.233412,15.003035,351,0,Unclear
2406:3003:2003:1c3b:dd11:a88e:d7a1:7c72,49442,2404:6800:4003:c1c::84,443,27,8875,1135,0,0,18,2724,9,6151,656.241978,67.558503,322,728,Google
192.168.10.126,49443,79.127.213.240,443,41,11361,1136,0,0,26,4700,15,6661,660.215857,18.049507,2083,2952,Google
192.168.10.126,49444,79.127.213.240,443,51,16069,1137,0,0,32,7604,19,8465,660.216525,18.05456,3369,3750,Google
192.168.10.126,49445,79.127.213.240,443,32,7154,1138,0,0,22,5022,10,2132,661.215263,26.03493,1543,655,Google
192.168.10.126,49446,192.168.10.1,53,15,1075,1139,0,0,10,634,5,441,669.211207,0.029203,173680,120809,Admin
192.168.10.126,49447,192.168.10.1,53,17,1167,1140,0,0,12,742,5,425,669.211333,0.034891,170129,97446,Admin
192.168.10.126,49448,192.168.10.1,53,15,1013,1141,0,0,10,634,5,379,669.21142,0.031657,160217,95776,Admin
192.168.10.126,49449,192.168.10.1,53,15,1089,1142,0,0,10,668,5,421,670.033728,0.029848,179040,112838,Admin
192.168.10.126,49450,192.168.10.1,53,17,1250,1143,0,0,12,776,5,474,670.034391,0.034119,181951,111140,Admin
192.168.10.126,49451,192.168.10.1,53,17,1209,1144,0,0,12,776,5,433,670.034941,0.034069,182218,101676,Admin
192.168.10.126,49452,18.215.193.248,443,55,16145,1145,0,0,34,7736,21,8409,670.064044,61.895164,999,1086,Unclear
192.168.10.126,49453,192.168.10.1,53,15,1080,1146,0,0,10,652,5,428,674.247558,0.024137,216099,141856,Admin
192.168.10.126,49454,192.168.10.1,53,17,1168,1147,0,0,12,760,5,408,674.247757,0.025178,241480,129636,Admin
192.168.10.126,49455,192.168.10.1,53,19,1296,1148,0,0,14,868,5,428,674.247907,0.056155,123657,60974,Admin
192.168.10.126,49456,79.127.213.244,443,44,13460,1149,0,0,28,6160,16,7300,674.275077,18.96047,2599,3080,Google
192.168.10.126,49457,192.168.10.1,53,17,1188,1150,0,0,12,760,5,428,675.20914,0.027446,221525,124754,Admin
192.168.10.126,49458,192.168.10.1,53,17,1168,1151,0,0,12,760,5,408,675.209455,0.031076,195649,105032,Admin
192.168.10.126,49459,192.168.10.1,53,15,1080,1152,0,0,10,652,5,428,675.209705,0.026881,194040,127376,Admin
192.168.10.126,49460,192.168.10.1,53,17,1186,1153,0,0,12,744,5,442,676.211132,0.035018,169969,100976,Admin
192.168.10.126,49461,192.168.10.1,53,15,1050,1154,0,0,10,636,5,414,676.211311,0.029243,173990,113257,Admin
192.168.10.126,49462,192.168.10.1,53,17,1186,1155,0,0,12,744,5,442,676.211438,0.034712,171468,101866,Admin
192.168.10.126,49463,79.127.213.244,443,32,7315,1156,0,0,22,5162,10,2153,680.490537,31.767855,1299,542,Google
192.168.10.126,49464,79.127.213.240,443,38,11179,1157,0,0,24,4592,14,6587,687.209315,2.062621,17810,25548,Google
192.168.10.126,49465,79.127.213.240,443,30,7163,1158,0,0,20,5014,10,2149,687.354017,12.883112,3113,1334,Google
192.168.10.126,49466,192.168.10.1,53,15,1018,1159,0,0,10,636,5,382,689.216947,0.043611,116667,70074,Admin
192.168.10.126,49467,192.168.10.1,53,17,1078,1160,0,0,12,744,5,334,689.217179,0.043379,137209,61596,Admin
192.168.10.126,49468,192.168.10.1,53,17,1138,1161,0,0,12,744,5,394,689.217327,0.069898,85152,45094,Admin
192.168.10.126,49469,52.20.78.240,443,55,14598,1162,0,0,36,8692,19,5906,690.552073,60.18888,1155,784,Unclear
192.168.10.126,49470,192.168.10.1,53,15,1080,1163,0,0,10,652,5,428,690.963899,0.224266,23258,15267,Admin
192.168.10.126,49471,192.168.10.1,53,15,1060,1164,0,0,10,652,5,408,690.964117,0.223951,23290,14574,Admin
192.168.10.126,49472,192.168.10.1,53,17,1188,1165,0,0,12,760,5,428,690.964261,0.22383,27163,15297,Admin
192.168.10.126,49473,192.168.10.1,53,17,1194,1166,0,0,12,738,5,456,691.577007,0.033172,177981,109972,Admin
192.168.10.126,49474,192.168.10.1,53,17,1193,1167,0,0,12,738,5,455,691.577462,0.038951,151575,93450,Admin
192.168.10.126,49475,192.168.10.1,53,15,1086,1168,0,0,10,630,5,456,691.578015,0.038397,131260,95007,Admin
192.168.10.126,49476,79.127.213.240,443,33,7238,1169,0,0,22,5054,11,2184,694.504863,20.767969,1946,841,Google
192.168.10.126,49477,192.168.10.1,53,17,1176,1170,0,0,12,760,5,416,695.213247,0.119041,51074,27956,Admin
192.168.10.126,49478,192.168.10.1,53,15,1060,1171,0,0,10,652,5,408,695.213516,0.11888,43876,27456,Admin
192.168.10.126,49479,192.168.10.1,53,16,1122,1172,0,0,12,760,4,362,695.213713,0.118575,51275,24423,Admin
2406:3003:2003:1c3b:dd11:a88e:d7a1:7c72,49480,2606:4700:3110::6812:32ad,443,28,7917,1173,0,0,18,1994,10,5923,695.24616,16.984526,939,2789,Google
192.168.10.126,49481,79.127.213.240,443,36,9677,1174,0,0,22,3164,14,6513,695.32215,78.382094,322,664,Google
192.168.10.126,49482,79.127.213.244,443,46,13566,1175,0,0,30,6268,16,7298,695.387159,16.862085,2973,3462,Google
192.168.10.126,49483,192.168.10.1,53,17,1166,1176,0,0,12,744,5,422,696.207661,0.610946,9742,5525,Admin
192.168.10.126,49484,192.168.10.1,53,17,1154,1177,0,0,12,744,5,410,696.207839,0.611575,9732,5363,Admin
192.168.10.126,49485,192.168.10.1,53,17,1183,1178,0,0,12,744,5,439,696.207976,0.611406,9734,5744,Admin
192.168.10.126,49486,10.91.207.234,7680,10,660,1179,0,0,10,660,0,0,696.233418,15.004669,351,0,Unclear
192.168.10.126,49487,10.91.34.162,7680,10,660,1180,0,0,10,660,0,0,696.233996,15.003122,351,0,Unclear
192.168.10.126,49488,10.91.189.112,7680,10,660,1181,0,0,10,660,0,0,696.23455,15.002659,351,0,Unclear
192.168.10.126,49489,192.168.10.1,53,17,1154,1182,0,0,12,744,5,410,696.671735,0.147321,40401,22264,Admin
2406:3003:2003:1c3b:dd11:a88e:d7a1:7c72,49490,2406:3003:2003:1c3b:5aef:68ff:febf:8de0,53,2,172,1183,0,0,2,172,0,0,696.671922,3.00E-06,,,Google
2406:3003:2003:1c3b:dd11:a88e:d7a1:7c72,49491,2406:3003:2003:1c3b:5aef:68ff:febf:8de0,53,2,172,1184,0,0,2,172,0,0,696.672059,2.00E-06,,,Google
192.168.10.126,49492,79.127.213.240,443,50,15830,1185,0,0,32,6412,18,9418,700.214184,15.013288,3416,5018,Google
192.168.10.126,49493,79.127.213.240,443,40,11305,1186,0,0,26,4700,14,6605,700.214855,14.042095,2677,3762,Google
192.168.10.126,49494,192.168.10.1,53,15,1037,1187,0,0,10,630,5,407,702.208401,0.032195,156546,101133,Admin
192.168.10.126,49495,192.168.10.1,53,15,1013,1188,0,0,10,630,5,383,702.20866,0.032025,157377,95675,Admin
192.168.10.126,49496,192.168.10.1,53,17,1250,1189,0,0,12,738,5,512,702.208834,0.031948,184800,128208,Admin
192.168.10.126,49497,79.127.213.241,443,149,60811,1190,0,0,96,32776,53,28035,702.209898,71.49443,3667,3137,Google
192.168.10.126,49498,79.127.213.240,443,32,8513,1191,0,0,20,3024,12,5489,706.208924,11.01077,2197,3988,Google
192.168.10.126,49499,192.168.10.1,53,15,1080,1192,0,0,10,652,5,428,710.21945,0.029556,176478,115847,Admin
192.168.10.126,49500,192.168.10.1,53,17,1168,1193,0,0,12,760,5,408,710.219686,0.030533,199128,106900,Admin
192.168.10.126,49501,192.168.10.1,53,17,1188,1194,0,0,12,760,5,428,710.219878,0.029146,208604,117477,Admin
192.168.10.126,49502,79.127.213.244,443,62,21062,1195,0,0,40,10840,22,10222,712.2161,26.031776,3331,3141,Google
192.168.10.126,49503,79.127.213.244,443,56,19261,1196,0,0,36,9280,20,9981,712.220327,26.019354,2853,3068,Google
192.168.10.126,49504,79.127.213.244,443,31,7238,1197,0,0,18,1688,13,5550,712.220853,16.001093,843,2774,Google
192.168.10.126,49505,52.182.143.208,443,35,15378,1198,0,0,24,7802,11,7576,712.720564,1.001348,62331,60526,Unclear
2406:3003:2003:1c3b:dd11:a88e:d7a1:7c72,49506,2001:db8:e612:837e:dbe7:9e8c:365a:bf93,443,10,860,1199,0,0,10,860,0,0,713.267769,15.000434,458,0,Unclear
192.168.10.126,49507,79.127.213.240,443,42,13639,1200,0,0,26,5940,16,7699,715.211161,13.011247,3652,4733,Google
192.168.10.126,49508,79.127.213.240,443,26,4681,1201,0,0,18,3666,8,1015,715.410321,10.833388,2707,749,Google
192.168.10.126,49509,192.168.10.1,53,15,1072,1202,0,0,10,632,5,440,718.633583,0.046725,108207,75334,Admin
192.168.10.126,49510,192.168.10.1,53,17,1152,1203,0,0,12,740,5,412,718.633805,0.02804,211126,117546,Admin
192.168.10.126,49511,192.168.10.1,53,17,1301,1204,0,0,12,740,5,561,718.634081,0.046227,128063,97086,Admin
192.168.10.126,49512,192.168.10.1,53,15,1135,1205,0,0,10,674,5,461,723.762121,0.024012,224554,153589,Admin
192.168.10.126,49513,192.168.10.1,53,17,1279,1206,0,0,12,782,5,497,723.76229,0.026877,232764,147933,Admin
192.168.10.126,49514,192.168.10.1,53,17,1188,1207,0,0,12,782,5,406,723.762401,0.026766,233729,121347,Admin
192.168.10.126,49515,192.168.10.1,53,15,997,1208,0,0,10,638,5,359,723.764732,0.027635,184693,103926,Admin
192.168.10.126,49516,192.168.10.1,53,15,985,1209,0,0,10,638,5,347,723.764939,0.035002,145820,79309,Admin
192.168.10.126,49517,192.168.10.1,53,15,1014,1210,0,0,10,638,5,376,723.765072,0.027115,188235,110934,Admin
192.168.10.126,49518,192.168.10.1,53,15,991,1211,0,0,10,634,5,357,723.76522,0.034698,146175,82310,Admin
192.168.10.126,49519,192.168.10.1,53,17,1087,1212,0,0,12,742,5,345,723.765339,0.034616,171481,79731,Admin
192.168.10.126,49520,192.168.10.1,53,15,1020,1213,0,0,10,634,5,386,723.765612,0.03438,147527,89819,Admin
2406:3003:2003:1c3b:dd11:a88e:d7a1:7c72,49521,2404:6800:4003:c0f::5e,443,22,5152,1214,0,0,16,3344,6,1808,723.791577,49.914761,535,289,Google
192.168.10.126,49522,192.168.10.1,53,15,1080,1215,0,0,10,632,5,448,724.079887,0.024229,208675,147921,Admin
192.168.10.126,49523,192.168.10.1,53,17,1184,1216,0,0,12,740,5,444,724.080143,0.023861,248103,148862,Admin
192.168.10.126,49524,192.168.10.1,53,17,1138,1217,0,0,12,740,5,398,724.080292,0.024337,243251,130829,Admin
192.168.10.126,49525,192.168.10.1,53,15,1096,1218,0,0,10,656,5,440,724.087962,0.023614,222241,149064,Admin
192.168.10.126,49526,192.168.10.1,53,15,1092,1219,0,0,10,656,5,436,724.088156,0.026791,195886,130192,Admin
192.168.10.126,49527,192.168.10.1,53,17,1161,1220,0,0,12,764,5,397,724.08827,0.023304,262272,136285,Admin
192.168.10.126,49528,192.168.10.1,53,15,1038,1221,0,0,10,654,5,384,724.124579,0.022526,232264,136375,Admin
192.168.10.126,49529,192.168.10.1,53,17,1146,1222,0,0,12,762,5,384,724.124907,0.01931,315691,159088,Admin
192.168.10.126,49530,192.168.10.1,53,17,1187,1223,0,0,12,762,5,425,724.125128,0.021984,277292,154657,Admin
192.168.10.126,49531,192.168.10.1,53,15,1096,1224,0,0,10,656,5,440,724.662145,0.023833,220198,147694,Admin
192.168.10.126,49532,192.168.10.1,53,17,1200,1225,0,0,12,764,5,436,724.662406,0.027871,219296,125148,Admin
192.168.10.126,49533,192.168.10.1,53,17,1149,1226,0,0,12,764,5,385,724.662551,0.023417,261006,131528,Admin
192.168.10.126,49534,192.168.10.1,53,15,1003,1227,0,0,10,642,5,361,725.065445,0.024466,209923,118041,Admin
192.168.10.126,49535,192.168.10.1,53,17,1099,1228,0,0,12,750,5,349,725.065632,0.024279,247127,114996,Admin
192.168.10.126,49536,192.168.10.1,53,17,1133,1229,0,0,12,750,5,383,725.065776,0.02928,204918,104644,Admin
192.168.10.126,49537,79.127.213.240,443,26,4581,1230,0,0,18,3566,8,1015,726.207967,5.026051,5676,1615,Google
192.168.10.126,49538,192.168.10.1,53,17,1130,1231,0,0,12,744,5,386,727.943013,0.024331,244626,126916,Admin
192.168.10.126,49539,192.168.10.1,53,17,1106,1232,0,0,12,744,5,362,727.943213,0.02413,246663,120016,Admin
192.168.10.126,49540,192.168.10.1,53,15,1023,1233,0,0,10,636,5,387,727.943322,0.026166,194450,118321,Admin
2406:3003:2003:1c3b:dd11:a88e:d7a1:7c72,49541,2404:6800:4003:c1a::78,443,48,13426,1234,0,0,32,5096,16,8330,727.963224,45.746845,891,1456,Google
192.168.10.126,49542,192.168.10.1,53,15,1111,1235,0,0,10,666,5,445,728.130837,0.028447,187295,125145,Admin
192.168.10.126,49543,192.168.10.1,53,17,1283,1236,0,0,12,774,5,509,728.13105,0.028108,220293,144869,Admin
192.168.10.126,49544,192.168.10.1,53,17,1176,1237,0,0,12,774,5,402,728.131184,0.027974,221348,114963,Admin
192.168.10.126,49545,192.168.10.1,53,15,1047,1238,0,0,10,652,5,395,728.563067,0.025949,201009,121777,Admin
192.168.10.126,49546,192.168.10.1,53,17,1162,1239,0,0,12,760,5,402,728.563202,0.030275,200825,106226,Admin
192.168.10.126,49547,192.168.10.1,53,17,1187,1240,0,0,12,760,5,427,728.563303,0.028935,210126,118057,Admin
192.168.10.126,49548,192.168.10.1,53,17,1198,1241,0,0,12,752,5,446,728.773536,0.041573,144709,85824,Admin
192.168.10.126,49549,192.168.10.1,53,17,1150,1242,0,0,12,752,5,398,728.773723,0.041273,145761,77144,Admin
192.168.10.126,49550,192.168.10.1,53,17,1287,1243,0,0,12,752,5,535,728.773864,0.041132,146260,104055,Admin
192.168.10.126,49551,192.168.10.1,53,15,1136,1244,0,0,10,650,5,486,729.438468,0.115094,45180,33781,Admin
192.168.10.126,49552,192.168.10.1,53,17,1288,1245,0,0,12,758,5,530,729.438651,0.025366,239060,167152,Admin
192.168.10.126,49553,192.168.10.1,53,17,1232,1246,0,0,12,758,5,474,729.438789,0.025228,240367,150309,Admin
192.168.10.126,49554,3.231.140.66,443,60,29044,1247,0,0,40,18940,20,10104,729.549302,11.000453,13773,7348,Unclear
192.168.10.126,49555,79.127.213.240,443,42,12058,1248,0,0,28,8126,14,3932,731.207203,17.013999,3820,1848,Google
192.168.10.126,49556,192.168.10.1,53,17,1146,1249,0,0,12,762,5,384,731.246056,0.022504,270885,136509,Admin
192.168.10.126,49557,192.168.10.1,53,15,1026,1250,0,0,10,654,5,372,731.246293,0.034361,152265,86609,Admin
192.168.10.126,49558,192.168.10.1,53,18,1241,1251,0,0,12,762,6,479,731.24642,0.034234,178068,111935,Admin
192.168.10.126,49559,192.168.10.1,53,15,1093,1252,0,0,10,632,5,461,732.132034,0.022748,222261,162124,Admin
192.168.10.126,49560,192.168.10.1,53,15,1077,1253,0,0,10,632,5,445,732.132341,0.026267,192484,135531,Admin
192.168.10.126,49561,192.168.10.1,53,17,1139,1254,0,0,12,740,5,399,732.132584,0.025993,227753,122802,Admin
192.168.10.126,49562,192.168.10.1,53,17,1099,1255,0,0,12,742,5,357,732.224624,0.023872,248659,119638,Admin
192.168.10.126,49563,192.168.10.1,53,15,979,1256,0,0,10,634,5,345,732.224763,0.026996,187879,102237,Admin
192.168.10.126,49564,192.168.10.1,53,17,1128,1257,0,0,12,742,5,386,732.224868,0.02689,220751,114838,Admin
192.168.10.126,49565,79.127.213.240,443,33,4983,1258,0,0,20,3674,13,1309,732.945641,15.275915,1924,685,Google
192.168.10.126,49571,192.168.10.1,53,15,997,1259,0,0,10,638,5,359,735.97303,0.023636,215941,121509,Admin
192.168.10.126,49572,192.168.10.1,53,15,973,1260,0,0,10,638,5,335,735.973417,0.023775,214679,112723,Admin
192.168.10.126,49573,192.168.10.1,53,17,1125,1261,0,0,12,746,5,379,735.97373,0.024319,245404,124676,Admin
192.168.10.126,49574,10.91.46.175,7680,10,660,1262,0,0,10,660,0,0,736.23507,15.009504,351,0,Unclear
192.168.10.126,49575,10.91.46.175,7680,10,660,1263,0,0,10,660,0,0,736.235752,15.002084,351,0,Unclear
192.168.10.126,49576,192.168.10.1,53,17,1188,1264,0,0,12,740,5,448,736.442294,0.042952,137828,83441,Admin
192.168.10.126,49577,192.168.10.1,53,17,1172,1265,0,0,12,740,5,432,736.442513,0.042745,138495,80851,Admin
192.168.10.126,49578,192.168.10.1,53,17,1138,1266,0,0,12,740,5,398,736.442681,0.042652,138797,74650,Admin
192.168.10.126,49579,192.168.10.1,53,15,991,1267,0,0,10,634,5,357,736.470932,0.033254,152523,85884,Admin
192.168.10.126,49580,192.168.10.1,53,15,979,1268,0,0,10,634,5,345,736.471152,0.030618,165654,90143,Admin
192.168.10.126,49581,192.168.10.1,53,17,1128,1269,0,0,12,742,5,386,736.471309,0.03288,180535,93917,Admin
2406:3003:2003:1c3b:dd11:a88e:d7a1:7c72,49582,2404:6800:4003:c05::5e,443,24,8436,1270,0,0,16,2390,8,6046,736.512401,37.193366,514,1300,Google
192.168.10.126,49583,192.168.10.1,53,15,1050,1271,0,0,10,654,5,396,736.528392,0.102874,50858,30794,Admin
192.168.10.126,49584,192.168.10.1,53,15,1038,1272,0,0,10,654,5,384,736.528579,0.10269,50949,29915,Admin
192.168.10.126,49585,192.168.10.1,53,17,1175,1273,0,0,12,762,5,413,736.528678,0.106555,57209,31007,Admin
192.168.10.126,49586,192.168.10.1,53,15,1024,1274,0,0,10,656,5,368,736.62944,0.054191,96842,54326,Admin
192.168.10.126,49587,192.168.10.1,53,15,1012,1275,0,0,10,656,5,356,736.629793,0.056313,93193,50574,Admin
192.168.10.126,49588,192.168.10.1,53,17,1154,1276,0,0,12,764,5,390,736.629981,0.055763,109606,55951,Admin
2406:3003:2003:1c3b:dd11:a88e:d7a1:7c72,49589,2404:6800:4003:c03::84,443,28,11890,1277,0,0,16,1870,12,10020,736.64381,37.062671,403,2162,Google
2406:3003:2003:1c3b:dd11:a88e:d7a1:7c72,49590,2404:6800:4003:c01::5f,443,31,12820,1278,0,0,18,2020,13,10800,736.693905,37.012464,436,2334,Google
192.168.10.126,49591,192.168.10.1,53,15,1111,1279,0,0,10,658,5,453,736.838358,0.021435,245579,169069,Admin
192.168.10.126,49592,192.168.10.1,53,17,1171,1280,0,0,12,766,5,405,736.83855,0.022714,269789,142643,Admin
192.168.10.126,49593,192.168.10.1,53,15,1200,1281,0,0,10,658,5,542,736.838708,0.022556,233374,192232,Admin
192.168.10.126,49594,192.168.10.1,53,17,1235,1282,0,0,12,758,5,477,736.839055,0.023232,261019,164256,Admin
192.168.10.126,49595,192.168.10.1,53,15,1079,1283,0,0,10,650,5,429,736.83923,0.027447,189456,125040,Admin
192.168.10.126,49596,192.168.10.1,53,17,1195,1284,0,0,12,758,5,437,736.839486,0.026401,229688,132419,Admin
192.168.10.126,49597,192.168.10.1,53,15,1068,1285,0,0,10,652,5,416,737.126068,0.025197,207008,132079,Admin
192.168.10.126,49598,192.168.10.1,53,17,1168,1286,0,0,12,760,5,408,737.126206,0.026891,226097,121378,Admin
192.168.10.126,49599,192.168.10.1,53,17,1188,1287,0,0,12,760,5,428,737.1263,0.057778,105230,59261,Admin
192.168.10.126,49600,79.127.213.240,443,73,24897,1288,0,0,46,12480,27,12417,737.155856,46.119585,2164,2153,Google
192.168.10.126,49601,192.168.10.1,53,15,1075,1289,0,0,10,634,5,441,737.186511,0.019783,256381,178334,Admin
192.168.10.126,49602,192.168.10.1,53,17,1167,1290,0,0,12,742,5,425,737.186715,0.019579,303181,173655,Admin
192.168.10.126,49603,192.168.10.1,53,17,1121,1291,0,0,12,742,5,379,737.186879,0.024452,242761,123998,Admin
192.168.10.126,49604,192.168.10.1,53,15,1080,1292,0,0,10,652,5,428,737.216046,0.03219,162037,106368,Admin
192.168.10.126,49605,192.168.10.1,53,17,1168,1293,0,0,12,760,5,408,737.216348,0.031887,190673,102361,Admin
192.168.10.126,49606,192.168.10.1,53,17,1188,1294,0,0,12,760,5,428,737.216565,0.064611,94101,52994,Admin
192.168.10.126,49607,192.168.10.1,53,15,1097,1295,0,0,10,634,5,463,738.183912,0.022837,222095,162192,Admin
192.168.10.126,49608,192.168.10.1,53,15,1253,1296,0,0,10,634,5,619,738.184057,0.021215,239076,233419,Admin
192.168.10.126,49609,192.168.10.1,53,17,1488,1297,0,0,12,742,5,746,738.184144,0.025978,228501,229732,Admin
192.168.10.126,49610,79.127.213.240,443,83,26797,1298,0,0,54,16370,29,10427,738.210932,46.020193,2845,1812,Google
192.168.10.126,49611,192.168.10.1,53,15,1078,1299,0,0,10,636,5,442,739.210534,0.035566,143057,99420,Admin
192.168.10.126,49612,192.168.10.1,53,17,1158,1300,0,0,12,744,5,414,739.21123,0.037064,160587,89358,Admin
192.168.10.126,49613,192.168.10.1,53,15,1078,1301,0,0,10,636,5,442,739.211701,0.03663,138902,96532,Admin
192.168.10.126,49614,192.168.10.1,53,15,1112,1302,0,0,10,638,5,474,740.63103,0.026201,194801,144727,Admin
192.168.10.126,49615,192.168.10.1,53,17,1204,1303,0,0,12,746,5,458,740.631354,0.025875,230647,141603,Admin
192.168.10.126,49616,192.168.10.1,53,17,1158,1304,0,0,12,746,5,412,740.631664,0.022643,263569,145563,Admin
2406:3003:2003:1c3b:dd11:a88e:d7a1:7c72,49617,2404:6800:4003:c04::8a,443,24,8491,1305,0,0,16,2430,8,6061,740.668429,33.037716,588,1467,Google
192.168.10.126,49618,192.168.10.1,53,15,991,1306,0,0,10,634,5,357,740.735269,0.021444,236523,133184,Admin
192.168.10.126,49619,192.168.10.1,53,17,1087,1307,0,0,12,742,5,345,740.735447,0.025594,231929,107837,Admin
192.168.10.126,49620,192.168.10.1,53,15,1008,1308,0,0,10,634,5,374,740.735568,0.021519,235698,139039,Admin
192.168.10.126,49621,79.127.213.240,443,38,10095,1309,0,0,26,6822,12,3273,746.082536,26.198968,2083,999,Google
192.168.10.126,49622,192.168.10.1,53,15,1084,1310,0,0,10,640,5,444,747.184408,0.025066,204260,141705,Admin
192.168.10.126,49623,192.168.10.1,53,27,1804,1311,0,0,18,1072,9,732,747.184573,1.033888,8294,5664,Admin
192.168.10.126,49624,192.168.10.1,53,17,1137,1312,0,0,12,748,5,389,747.18471,0.024764,241641,125666,Admin
2406:3003:2003:1c3b:dd11:a88e:d7a1:7c72,49625,2404:6800:4003:c00::5f,443,8,688,1313,0,0,2,172,6,516,747.205916,30.912047,44,133,Google
2406:3003:2003:1c3b:dd11:a88e:d7a1:7c72,49626,2404:6800:4003:c00::5f,443,8,688,1314,0,0,2,172,6,516,747.456852,30.997875,44,133,Google
192.168.10.126,49627,74.125.68.95,443,27,6865,1315,0,0,18,1668,9,5197,747.507245,26.199928,509,1586,Google
192.168.10.126,49628,74.125.68.95,443,34,10862,1316,0,0,22,3518,12,7344,747.758928,25.947763,1084,2264,Google
192.168.10.126,49629,79.127.213.240,443,38,11197,1317,0,0,24,4592,14,6605,748.209981,11.013916,3335,4797,Google
192.168.10.126,49630,79.127.213.240,443,32,8525,1318,0,0,20,3036,12,5489,748.211313,13.090607,1855,3354,Google
192.168.10.126,49631,79.127.213.240,443,39,11168,1319,0,0,24,4492,15,6676,748.211833,11.063189,3248,4827,Google
192.168.10.126,49632,192.168.10.1,53,15,1063,1320,0,0,10,634,5,429,748.276482,0.02407,210718,142584,Admin
192.168.10.126,49633,192.168.10.1,53,15,1059,1321,0,0,10,634,5,425,748.276719,0.023839,212760,142623,Admin
192.168.10.126,49634,192.168.10.1,53,17,1109,1322,0,0,12,742,5,367,748.276876,0.026564,223460,110525,Admin
2406:3003:2003:1c3b:dd11:a88e:d7a1:7c72,49635,2404:6800:4003:c06::8b,443,57,21228,1323,0,0,32,9198,25,12030,748.299743,25.410594,2895,3787,Google
2406:3003:2003:1c3b:dd11:a88e:d7a1:7c72,49636,2404:6800:4003:c06::8b,443,19,4902,1324,0,0,14,3186,5,1716,748.360077,25.345966,1005,541,Google
2406:3003:2003:1c3b:dd11:a88e:d7a1:7c72,49637,2406:3003:2003:1c3b:5aef:68ff:febf:8de0,53,4,344,1325,0,0,4,344,0,0,748.364821,1.000019,2751,0,Google
2406:3003:2003:1c3b:dd11:a88e:d7a1:7c72,49638,2406:3003:2003:1c3b:5aef:68ff:febf:8de0,53,4,344,1326,0,0,4,344,0,0,748.365041,0.999887,2752,0,Google
2406:3003:2003:1c3b:dd11:a88e:d7a1:7c72,49639,2406:3003:2003:1c3b:5aef:68ff:febf:8de0,53,4,344,1327,0,0,4,344,0,0,748.365158,0.999708,2752,0,Google
192.168.10.126,49640,192.168.10.1,53,15,1098,1328,0,0,10,646,5,452,748.449344,0.020652,250242,175092,Admin
192.168.10.126,49641,192.168.10.1,53,15,1048,1329,0,0,10,646,5,402,748.449497,0.017489,295500,183887,Admin
192.168.10.126,49642,192.168.10.1,53,17,1206,1330,0,0,12,754,5,452,748.449651,0.020345,296485,177734,Admin
192.168.10.126,49643,3.6.211.252,443,47,16663,1331,0,0,28,8810,19,7853,748.46726,25.302287,2785,2482,Unclear
192.168.10.126,49644,192.168.10.1,53,20,1400,1332,0,0,14,866,6,534,749.375932,0.580222,11940,7362,Admin
192.168.10.126,49645,192.168.10.1,53,17,1166,1333,0,0,12,758,5,408,749.376205,0.020532,295343,158971,Admin
192.168.10.126,49646,192.168.10.1,53,20,1338,1334,0,0,14,866,6,472,749.37642,0.579734,11950,6513,Admin
192.168.10.126,49647,192.168.10.1,53,15,1006,1335,0,0,10,644,5,362,750.03464,0.03016,170822,96021,Admin
192.168.10.126,49648,192.168.10.1,53,17,1102,1336,0,0,12,752,5,350,750.035075,0.033911,177405,82569,Admin
192.168.10.126,49649,192.168.10.1,53,17,1143,1337,0,0,12,752,5,391,750.035285,0.033701,178511,92816,Admin
2406:3003:2003:1c3b:dd11:a88e:d7a1:7c72,49650,2404:6800:4003:c00::5f,443,34,11335,1338,0,0,22,3832,12,7503,750.067199,23.638925,1296,2539,Google
2406:3003:2003:1c3b:dd11:a88e:d7a1:7c72,49651,2404:6800:4003:c0f::5e,443,386,296130,1339,0,0,154,16234,232,279896,750.114163,23.595998,5503,94896,Google
192.168.10.126,49652,192.168.10.1,53,15,1018,1340,0,0,10,636,5,382,750.208873,0.022158,229623,137918,Admin
192.168.10.126,49653,192.168.10.1,53,17,1090,1341,0,0,12,744,5,346,750.209098,0.014254,417566,194191,Admin
192.168.10.126,49654,192.168.10.1,53,17,1126,1342,0,0,12,744,5,382,750.209223,0.024586,242088,124298,Admin
192.168.10.126,49655,3.220.57.224,443,48,14196,1343,0,0,32,8476,16,5720,750.527388,50.490009,1342,906,Unclear
192.168.10.126,49656,192.168.10.1,53,15,1128,1344,0,0,10,664,5,464,750.536602,0.023947,221823,155008,Admin
192.168.10.126,49657,192.168.10.1,53,17,1223,1345,0,0,12,772,5,451,750.536819,0.023402,263909,154174,Admin
192.168.10.126,49658,192.168.10.1,53,17,1236,1346,0,0,12,772,5,464,750.536982,0.026553,232591,139795,Admin
192.168.10.126,49659,13.227.254.38,443,31,6607,1347,0,0,20,5162,11,1445,750.560777,23.148904,1783,499,Google
192.168.10.126,49660,192.168.10.1,53,17,1129,1348,0,0,12,762,5,367,752.792381,0.030041,202922,97733,Admin
192.168.10.126,49661,192.168.10.1,53,17,1117,1349,0,0,12,762,5,355,752.79253,0.027795,219320,102176,Admin
192.168.10.126,49662,192.168.10.1,53,17,1158,1350,0,0,12,762,5,396,752.792751,0.033039,184509,95886,Admin
2406:3003:2003:1c3b:dd11:a88e:d7a1:7c72,49663,2404:6800:4003:c1c::84,443,54,17845,1351,0,0,36,5606,18,12239,752.820942,20.889268,2146,4687,Google
192.168.10.126,49669,192.168.10.1,53,15,1084,1352,0,0,10,634,5,450,753.00186,0.023462,216179,153439,Admin
192.168.10.126,49670,192.168.10.1,53,17,1188,1353,0,0,12,742,5,446,753.002077,0.023728,250168,150370,Admin
192.168.10.126,49671,192.168.10.1,53,17,1142,1354,0,0,12,742,5,400,753.002196,0.023617,251344,135495,Admin
192.168.10.126,49672,192.168.10.1,53,17,1207,1355,0,0,12,750,5,457,753.012591,0.023366,256783,156466,Admin
192.168.10.126,49673,192.168.10.1,53,17,1203,1356,0,0,12,750,5,453,753.012849,0.026044,230379,139149,Admin
192.168.10.126,49674,192.168.10.1,53,17,1145,1357,0,0,12,750,5,395,753.01308,0.022879,262249,138117,Admin
2406:3003:2003:1c3b:dd11:a88e:d7a1:7c72,49675,2404:6800:4003:c1c::64,443,87,59920,1358,0,0,40,8772,47,51148,753.023229,20.687104,3392,19779,Google
2406:3003:2003:1c3b:dd11:a88e:d7a1:7c72,49676,2404:6800:4003:c05::71,443,63,32156,1359,0,0,34,9292,29,22864,753.03398,20.676421,3595,8846,Google
192.168.10.126,49677,192.168.10.1,53,15,1063,1360,0,0,10,634,5,429,753.275018,0.020351,249226,168640,Admin
192.168.10.126,49678,192.168.10.1,53,17,1155,1361,0,0,12,742,5,413,753.275187,0.020183,294108,163702,Admin
192.168.10.126,49679,192.168.10.1,53,17,1121,1362,0,0,12,742,5,379,753.275347,0.022187,267544,136656,Admin
192.168.10.126,49680,192.168.10.1,53,17,1207,1363,0,0,12,766,5,441,754.436992,0.054327,112798,64940,Admin
192.168.10.126,49681,192.168.10.1,53,17,1159,1364,0,0,12,766,5,393,754.437366,0.042636,143728,73740,Admin
192.168.10.126,49682,192.168.10.1,53,17,1308,1365,0,0,12,766,5,542,754.43765,0.03916,156486,110725,Admin
192.168.10.126,49683,192.168.10.1,53,17,1217,1366,0,0,12,742,5,475,754.728292,0.023809,249317,159603,Admin
192.168.10.126,49684,192.168.10.1,53,15,1241,1367,0,0,10,634,5,607,754.729224,0.029052,174583,167148,Admin
192.168.10.126,49686,192.168.10.1,53,17,1488,1368,0,0,12,742,5,746,754.729659,0.029622,200391,201471,Admin
192.168.10.126,49687,192.168.10.1,53,17,1247,1369,0,0,12,780,5,467,755.245487,0.032228,193620,115924,Admin
192.168.10.126,49688,192.168.10.1,53,17,1235,1370,0,0,12,780,5,455,755.245928,0.031578,197605,115270,Admin
192.168.10.126,49689,192.168.10.1,53,17,1315,1371,0,0,12,780,5,535,755.246227,0.031267,199571,136885,Admin
192.168.10.126,49690,192.168.10.1,53,17,1293,1372,0,0,12,776,5,517,755.277332,0.101196,61346,40871,Admin
192.168.10.126,49691,192.168.10.1,53,23,1593,1373,0,0,16,992,7,601,755.277723,0.403322,19676,11920,Admin
192.168.10.126,49692,192.168.10.1,53,17,1282,1374,0,0,12,776,5,506,755.278098,0.410539,15121,9860,Admin
192.168.10.126,49693,192.168.10.1,53,19,1388,1375,0,0,14,878,5,510,755.278798,0.119881,58591,34033,Admin
192.168.10.126,49694,192.168.10.1,53,17,1256,1376,0,0,12,770,5,486,755.279368,0.099264,62056,39168,Admin
192.168.10.126,49695,192.168.10.1,53,16,1227,1377,0,0,12,770,4,457,755.279776,0.076843,80163,47577,Admin
192.168.10.126,49696,192.168.10.1,53,17,1188,1378,0,0,12,760,5,428,755.326468,0.361367,16825,9475,Admin
192.168.10.126,49697,192.168.10.1,53,21,1384,1379,0,0,14,868,7,516,755.327493,0.353552,19640,11675,Admin
192.168.10.126,49699,192.168.10.1,53,23,1500,1380,0,0,16,976,7,524,755.327849,0.353196,22106,11868,Admin
192.168.10.126,49700,192.168.10.1,53,15,1012,1381,0,0,10,656,5,356,755.524703,0.180298,29107,15796,Admin
192.168.10.126,49701,192.168.10.1,53,15,1012,1382,0,0,10,656,5,356,755.525019,0.186894,28080,15238,Admin
192.168.10.126,49702,192.168.10.1,53,17,1154,1383,0,0,12,764,5,390,755.525533,0.186314,32804,16745,Admin
192.168.10.126,49703,192.168.10.1,53,15,1075,1384,0,0,10,634,5,441,755.56177,0.1508,33633,23395,Admin
192.168.10.126,49704,192.168.10.1,53,15,1047,1385,0,0,10,634,5,413,755.562459,0.150251,33756,21989,Admin
192.168.10.126,49705,192.168.10.1,53,15,1001,1386,0,0,10,634,5,367,755.562909,0.153153,33117,19170,Admin
192.168.10.126,49706,79.127.213.243,443,42,13714,1387,0,0,26,6004,16,7710,755.639123,19.612121,2449,3144,Google
192.168.10.126,49707,192.168.10.1,53,15,1186,1388,0,0,10,670,5,516,755.672367,0.045594,117559,90538,Admin
192.168.10.126,49708,192.168.10.1,53,17,1249,1389,0,0,12,778,5,471,755.672697,0.045293,137416,83191,Admin
192.168.10.126,49709,192.168.10.1,53,17,1294,1390,0,0,12,778,5,516,755.672977,0.047157,131984,87537,Admin
192.168.10.126,49710,192.168.10.1,53,15,1037,1391,0,0,10,630,5,407,756.587864,0.078981,63812,41225,Admin
192.168.10.126,49711,192.168.10.1,53,15,1001,1392,0,0,10,630,5,371,756.588432,0.079756,63192,37213,Admin
192.168.10.126,49712,192.168.10.1,53,17,1250,1393,0,0,12,738,5,512,756.588942,0.079246,74502,51687,Admin
192.168.10.126,49718,79.127.213.240,443,32,8525,1394,0,0,20,3036,12,5489,761.231382,3.270124,7427,13428,Google
192.168.10.126,49719,79.127.213.240,443,28,4745,1395,0,0,20,3730,8,1015,764.236487,5.994028,4978,1354,Google
192.168.10.126,49720,79.127.213.240,443,52,11273,1396,0,0,34,7110,18,4163,770.208025,14.0231,4056,2374,Google
192.168.10.126,49721,79.127.213.240,443,31,7231,1397,0,0,20,1796,11,5435,770.209212,3.494849,4111,12441,Google
192.168.10.126,49722,192.168.10.1,53,17,1188,1398,0,0,12,760,5,428,772.244514,0.069767,87147,49077,Admin
192.168.10.126,49723,192.168.10.1,53,17,1168,1399,0,0,12,760,5,408,772.245074,0.033478,181611,97496,Admin
192.168.10.126,49724,192.168.10.1,53,17,1176,1400,0,0,12,760,5,416,772.245391,0.025286,240449,131614,Admin
192.168.10.126,49725,79.127.213.240,443,32,8529,1401,0,0,20,3040,12,5489,772.247436,11.004022,2210,3990,Google
192.168.10.126,49726,192.168.10.1,53,17,1204,1402,0,0,12,764,5,440,772.343427,0.025052,243972,140507,Admin
192.168.10.126,49727,192.168.10.1,53,17,1200,1403,0,0,12,764,5,436,772.343735,0.027664,220936,126084,Admin
192.168.10.126,49728,192.168.10.1,53,17,1149,1404,0,0,12,764,5,385,772.344102,0.026736,228605,115200,Admin
2406:3003:2003:1c3b:dd11:a88e:d7a1:7c72,49729,2404:6800:4003:c1a::64,443,48,16117,1405,0,0,32,5140,16,10977,772.367197,1.339435,30699,65561,Google
192.168.10.126,49730,192.168.10.1,53,15,1096,1406,0,0,10,656,5,440,772.507715,0.025017,209777,140704,Admin
192.168.10.126,49731,192.168.10.1,53,17,1200,1407,0,0,12,764,5,436,772.508102,0.025656,238228,135952,Admin
192.168.10.126,49732,192.168.10.1,53,17,1161,1408,0,0,12,764,5,397,772.508561,0.026174,233514,121341,Admin
2406:3003:2003:1c3b:dd11:a88e:d7a1:7c72,49733,2404:6800:4003:c0f::8b,443,62,21147,1409,0,0,42,7342,20,13805,772.532175,1.177493,49882,93792,Google
2406:3003:2003:1c3b:dd11:a88e:d7a1:7c72,49734,2404:6800:4003:c0f::5e,443,55,11244,1410,0,0,36,6610,19,4634,774.064996,10.166129,5201,3646,Google
192.168.10.126,49735,79.127.213.241,443,48,12866,1411,0,0,30,5024,18,7842,774.219092,10.001686,4018,6272,Google
192.168.10.126,49736,79.127.213.243,443,64,23297,1412,0,0,40,12072,24,11225,775.209574,31.044451,3110,2892,Google
192.168.10.126,49737,68.232.45.61,443,56,14424,1413,0,0,36,6700,20,7724,777.209762,7.021363,7633,8800,Unclear
192.168.10.126,49738,192.168.10.1,53,15,1123,1414,0,0,10,666,5,457,782.562336,0.622607,8557,5872,Admin
192.168.10.126,49739,192.168.10.1,53,15,1187,1415,0,0,10,666,5,521,782.562592,0.622351,8561,6697,Admin
192.168.10.126,49740,192.168.10.1,53,15,1068,1416,0,0,10,666,5,402,782.562813,0.629285,8466,5110,Admin
192.168.10.126,49741,192.168.10.1,53,17,1231,1417,0,0,12,774,5,457,783.026865,0.155436,39836,23520,Admin
2406:3003:2003:1c3b:dd11:a88e:d7a1:7c72,49742,2406:3003:2003:1c3b:5aef:68ff:febf:8de0,53,2,172,1418,0,0,2,172,0,0,783.027721,2.60E-05,,,Google
2406:3003:2003:1c3b:dd11:a88e:d7a1:7c72,49743,2406:3003:2003:1c3b:5aef:68ff:febf:8de0,53,2,172,1419,0,0,2,172,0,0,783.028296,7.00E-06,,,Google
192.168.10.126,49744,79.127.213.241,443,36,7514,1420,0,0,22,1904,14,5610,783.174099,1.046423,14556,42888,Google
192.168.10.126,49745,79.127.213.240,443,42,13350,1421,0,0,26,6052,16,7298,783.215354,14.033771,3449,4160,Google
192.168.10.126,49746,79.127.213.240,443,44,10957,1422,0,0,30,8046,14,2911,783.329144,12.916551,4983,1802,Google
192.168.10.126,49747,79.127.213.241,443,33,8678,1423,0,0,20,3136,13,5542,784.211178,11.103603,2259,3992,Google
192.168.10.126,49748,79.127.213.241,443,46,15154,1424,0,0,28,6284,18,8870,784.212639,17.046935,2949,4162,Google
192.168.10.126,49749,79.127.213.240,443,29,7123,1425,0,0,18,1688,11,5435,784.468248,9.238998,1461,4706,Google
192.168.10.126,49750,192.168.10.1,53,19,1424,1426,0,0,14,1020,5,404,784.722831,0.774871,10530,4171,Admin
192.168.10.126,49751,192.168.10.1,53,23,1628,1427,0,0,16,1128,7,500,784.723403,0.774405,11652,5165,Admin
192.168.10.126,49752,192.168.10.1,53,23,1681,1428,0,0,16,1128,7,553,784.723847,0.773881,11660,5716,Admin
192.168.10.126,49753,192.168.10.1,53,7,414,1429,0,0,6,348,1,66,785.188253,0.301678,9228,1750,Admin
2406:3003:2003:1c3b:dd11:a88e:d7a1:7c72,49754,2406:3003:2003:1c3b:5aef:68ff:febf:8de0,53,2,172,1430,0,0,2,172,0,0,785.188471,4.00E-06,,,Google
2406:3003:2003:1c3b:dd11:a88e:d7a1:7c72,49755,2406:3003:2003:1c3b:5aef:68ff:febf:8de0,53,2,172,1431,0,0,2,172,0,0,785.188621,3.00E-06,,,Google
192.168.10.126,49756,68.232.45.61,443,45,14074,1432,0,0,30,6632,15,7442,786.215957,7.490813,7082,7947,Unclear
192.168.10.126,49757,192.168.10.1,53,17,1156,1433,0,0,12,780,5,376,794.218877,0.168535,37024,17847,Admin
192.168.10.126,49758,192.168.10.1,53,15,1036,1434,0,0,10,672,5,364,794.219044,0.168367,31930,17295,Admin
192.168.10.126,49759,192.168.10.1,53,17,1173,1435,0,0,12,780,5,393,794.219147,0.168288,37079,18682,Admin
2406:3003:2003:1c3b:dd11:a88e:d7a1:7c72,49760,2001:4860:4802:38::87,443,33,13847,1436,0,0,20,3988,13,9859,794.243477,9.463526,3371,8334,Unclear
192.168.10.126,49761,79.127.213.241,443,36,10883,1437,0,0,22,3268,14,7615,795.210997,8.496917,3076,7169,Google
192.168.10.126,49762,79.127.213.241,443,47,13452,1438,0,0,30,4964,17,8488,795.211652,8.495344,4674,7993,Google
192.168.10.126,49763,79.127.213.241,443,29,7123,1439,0,0,18,1688,11,5435,795.211954,8.498794,1588,5116,Google
192.168.10.126,49764,79.127.213.241,443,31,7231,1440,0,0,20,1796,11,5435,795.212382,8.494794,1691,5118,Google
192.168.10.126,49765,68.232.45.61,443,58,15887,1441,0,0,38,7162,20,8725,796.207663,7.499189,7640,9307,Unclear
192.168.10.126,49766,79.127.213.240,443,33,10926,1442,0,0,20,4384,13,6542,796.210043,3.008541,11657,17395,Google
192.168.10.126,49767,79.127.213.240,443,32,8512,1443,0,0,20,3040,12,5472,796.210705,11.013554,2208,3974,Google
192.168.10.126,49768,192.168.10.1,53,15,1080,1444,0,0,10,652,5,428,797.209737,0.026173,199289,130821,Admin
192.168.10.126,49769,192.168.10.1,53,17,1168,1445,0,0,12,760,5,408,797.209975,0.031244,194597,104468,Admin
192.168.10.126,49770,192.168.10.1,53,17,1188,1446,0,0,12,760,5,428,797.21019,0.028418,213948,120487,Admin
192.168.10.126,49771,192.168.10.1,53,15,1066,1447,0,0,10,636,5,430,801.210182,0.033787,150590,101814,Admin
192.168.10.126,49772,192.168.10.1,53,15,1038,1448,0,0,10,636,5,402,801.210389,0.028745,177004,111880,Admin
192.168.10.126,49773,192.168.10.1,53,15,1066,1449,0,0,10,636,5,430,801.210664,0.033295,152815,103318,Admin
192.168.10.126,49774,192.168.10.1,53,15,1080,1450,0,0,10,652,5,428,801.211251,0.443458,11762,7721,Admin
192.168.10.126,49775,192.168.10.1,53,15,1060,1451,0,0,10,652,5,408,801.211451,0.032508,160452,100406,Admin
192.168.10.126,49776,192.168.10.1,53,17,1188,1452,0,0,12,760,5,428,801.211594,0.443969,13694,7712,Admin
192.168.10.126,49777,192.168.10.1,53,4,264,1453,0,0,2,132,2,132,801.646581,4.565733,231,231,Admin
2406:3003:2003:1c3b:dd11:a88e:d7a1:7c72,49778,2406:3003:2003:1c3b:5aef:68ff:febf:8de0,53,2,172,1454,0,0,2,172,0,0,801.646893,5.00E-06,,,Google
192.168.10.126,49779,79.127.213.244,443,26,5766,1455,0,0,18,3726,8,2040,801.653176,5.597561,5325,2915,Google
192.168.10.126,49780,79.127.213.244,443,35,9714,1456,0,0,22,3148,13,6566,801.905696,1.802219,13973,29146,Google
192.168.10.126,49781,79.127.213.241,443,27,8373,1457,0,0,16,2920,11,5453,804.20769,0.031551,740388,1382650,Google
192.168.10.126,49782,10.91.89.132,7680,6,396,1458,0,0,6,396,0,0,805.469953,3.000082,1055,0,Unclear
192.168.10.126,49783,10.91.115.51,7680,6,396,1459,0,0,6,396,0,0,805.470975,3.002958,1054,0,Unclear
192.168.10.126,49784,79.127.213.243,443,27,8243,1460,0,0,16,2808,11,5435,806.213117,0.044044,510035,987194,Google
192.168.10.126,49785,68.232.45.61,443,38,12311,1461,0,0,24,5888,14,6423,806.214359,0.298249,157935,172285,Unclear
192.168.10.126,49786,79.127.213.241,443,29,8384,1462,0,0,18,2932,11,5452,807.207947,0.036382,644714,1198834,Google
192.168.10.126,49787,79.127.213.241,443,24,6852,1463,0,0,14,1472,10,5380,807.209154,0.035906,327967,1198685,Google
